
   
        
           
               Hollandsch en Hoogduitsch woordenboekje
               Inhoudende alle dagelijks voorkomende Duitsche woorden, gesprekken enz. naar de Hollandsche spelling zamengesteld, om het Hoogduitsch te verstaan en zonder meester te leeren spreken
           
           
               
                   Dit bestand biedt, behoudens een aantal hierna te noemen ingrepen, een diplomatische weergave van Hollandsch en Hoogduitsch woordenboekje, inhoudende alle dagelijks voorkomende Duitsche woorden, gesprekken enz. naar de Hollandsche spelling zamengesteld, om het Hoogduitsch te verstaan en zonder meester te leeren spreken uit 1814. Er is gebruikgemaakt van een door Stichting Vrijwilligersnetwerk Nederlandse Taal o.l.v. Nicoline van der Sijs en Hans Beelen aangeleverd bestand.
               
               
                   
                       In het origineel begint de paginanummering bij 3. Dat is hier ongewijzigd overgenomen.
                       p. π1: SPEELING → SPELLING: ‘...NAAR DE HOLLANDSCHE SPELLING ZAMENGESTELD...’.
                       p. III: In het origineel staan in deze regels horizontale strepen om de herhaling van ‘bijna als’ aan te geven:
                           ‘ï bijna als ii of ie
                           ae bijna als e’.
                       p. 3: baarbij → daarbij: ‘Eeten, Drinken en hetgeen daarbij gebruikt word.’.
                       p. 6: ‘Brendwain’ drie regels naar boven verplaatst.
                       p. 22: Feuster → Fenster.
                       p. 23: Ren → Een: ‘Een Stoel’.
                       p. 38: Boedkrukker → Boekdrukker.
                       p. 44: en → Een: ‘Een vlieg’; en → Een: ‘Een worm’.
                       p. 47: gegroer → gegroet: ‘Zijt gegroet of adieu goede vriend’.
                       p. 49: vtaag → vraag: ‘Ik vraag excus’.
                       p. 50: gekommeu → gekommen: ‘Er ist viermaal mit bloetigen kof davon gekommen’.
                   
               
           
           
           
               _hol021holl01_01
               DBNL-TEI 1
               
                   2020 dbnl
               
           
           
               
           
           
               
                   
                   exemplaar Koninklijke Bibliotheek Den Haag, signatuur: 3037 H 38, scans van Google Books
               
               Hollandsch en Hoogduitsch woordenboekje, inhoudende alle dagelijks voorkomende Duitsche woorden, gesprekken enz. naar de Hollandsche spelling zamengesteld, om het Hoogduitsch te verstaan en zonder meester te leeren spreken. Amsterdam, E. Maaskamp z.j. [1814]
               
           
       
       
           
               Wijze van coderen: standaard
               
           
       
       
           
               Nederlands
           
       
       
           
               Hollandsch en Hoogduitsch woordenboekje
               Inhoudende alle dagelijks voorkomende Duitsche woorden, gesprekken enz. naar de Hollandsche spelling zamengesteld, om het Hoogduitsch te verstaan en zonder meester te leeren spreken
               
               
               
                   
                   
                   
               
           
           
           
           
               
           
           
               
               
           
           
           
           
       
       
           
               Hollandsch en Hoogduitsch woordenboekje
               Inhoudende alle dagelijks voorkomende Duitsche woorden, gesprekken enz. naar de Hollandsche spelling zamengesteld, om het Hoogduitsch te verstaan en zonder meester te leeren spreken
               
               
               
                   
                   
                   
               
           
           
           
           
               
           
           
               
               
           
           
           
           
       
       
           
               2020-04-09
               
                   CvP
               
               colofon toegevoegd
           
       
   

Verantwoording 

Dit tekstbestand is gebaseerd op een bestand van de Digitale Bibliotheek voor de Nederlandse Letteren (https://www.dbnl.org)

Bron: Hollandsch en Hoogduitsch woordenboekje, inhoudende alle dagelijks voorkomende Duitsche woorden, gesprekken enz. naar de Hollandsche spelling zamengesteld, om het Hoogduitsch te verstaan en zonder meester te leeren spreken. Amsterdam, E. Maaskamp z.j. [1814]
 
Zie: https://www.dbnl.org/tekst/_hol021holl01_01/colofon.php

In dit bestand zijn twee typen markeringen opgenomen: paginanummering en illustraties met onderschriften. Deze zijn te onderscheiden van de rest van de tekst door middel van accolades: {==13==} {>>pagina-aanduiding<<} {==Figuur. 1: Onderschrift van de afbeelding.==} {>>afbeelding<<} 




    
{==π1==} {>>pagina-aanduiding<<}

HOLLANDSCH EN HOOGDUITSCH
WOORDENBOEKJE,

inhoudende

ALLE DAGELIJKS VOORKOMENDE DUITSCHE WOORDEN, GESPREKKEN ENZ.
NAAR DE HOLLANDSCHE SPELLING ZAMENGESTELD, OM HET HOOGDUITSCH TE VERSTAAN EN ZONDER MEESTER TE LEEREN SPREKEN.

Te Amsterdam,
Bij E. MAASKAMP,
Dam en Kalverstraat, No. 1.

    
{==π2==} {>>pagina-aanduiding<<}





    
{==I==} {>>pagina-aanduiding<<}

Voorberigt.

Ofschoon de Hoogduitsche taal als veel met de onze overeenkomende, redelijk voor een Hollander te verstaan valt; zijn 'er toch onnoemlijk veele woorden in die geheel van het Hollandsch verschillen; en daar men dagelijks zoo door benodigde inkwartiering van Duitsche Troepen als anderzins dezelve een weinig dient machtig te zijn, is den Uitgever dezes, door de reeds in het licht zijnde en 
{==II==} {>>pagina-aanduiding<<}
 bij hem uitgegeven Hulpboekjes om het Engelsch en Russisch te verstaan, op den inval gekomen om een dergelijk voor het Hoogduitsch te vervaardigen  *, niet om de gronden of spelling, veel minder het leezen of schrijven dier taal te leeren  †, maar alleen om dezelve goed te verstaan en te spreken. Hij twijfelt geenzins of zal voor des benoodigde aangenaam, en een redelijk debiet de vruchten zijner onderneming zijn.

{==III==} {>>pagina-aanduiding<<}

Tot het wel uitspreken van sommige in dit boekje voorkomende woorden dient in acht genomen te worden dat men de onderstaande letters en woorden aldus uitspreekt
ü bijna als ie of als uu
ï bijna als ii of ie
ae bijna als e bijvoorbeeld:
aen aet enz. als en en et
sj even als de gewoonlijke klank in de Hollandsche woorden sjouwen, sjoert, artisjok enz. Voorts wordt de letter s in het begin van woorden met een sterke sissing, en in het midden of aan het einde van woorden voorkomende, iets zachter uitgesproken.



    
{==IV==} {>>pagina-aanduiding<<}

Inhoud.


I.	Eeten en drinken en hetgeen daarby gebruikt wordt	Bladz. 5
II.	Godheid, Godsdienst, enz.	8
III.	Van de Tyd, de namen der Maanden, Dagen en Feestdagen	9
IV.	Van de Elementen, het Weder enz.	11
V.	 Bloedverwandschap enz.	13
VI.	Van den Mensch enz.	14
VII.	Van de Getallen, Maten en Gewigten	16
VIII.	Klederyen enz.	19
IX.	Huizen en Gestichten, derzelver deelen enz.	21
X.	Meubelen en huizelyke gereedschappen.	25
XI.	Kantoor-Zaken, enz.	25
XII.	Musiek-Instrumenten, enz.	27
XIII.	Regeringsmagten, Oorlogs-Wapenen enz.	28
XIV.	Landen, Volkeren, enz.	32
XV.	Men vindt op het Land of in de Stad	33
XVI.	Rytuig, Stalgereedschap, enz.	35
XVII.	Metalen, Verwen, enz.	57
XVIII.	Handwerken, Beroepen, enz.	38
XIX.	Viervoetige Dieren	40
XX.	Vogelen	42
XXI.	Kruipende Dieren en Insecten	43
XXII.	Vragen en Antwoorden, veel voorkomende gezegdens, enz.	44




    
{==3==} {>>pagina-aanduiding<<}

I. Eeten, Drinken en hetgeen daarbij gebruikt word.


Het Eeten	Das Essen
Brood	Brood
Wijn	Wain
Bier	Bier
Vleesch	Flaisj
Vis	Fiesj
Gebraden	Gebratens
Een stuk Brood of Vleesch	Ain Stuuk Brood oder Flaisj



{==4==} {>>pagina-aanduiding<<}


Soep	Aine Soepe
Saus	Toenke of bruhe
Een Ei	Ain Ai
Nageregt Desert	Der Nachtiesj
Kaas	Kaeze of Keeze
Zout	Zalts
Peper	Feffer
Olie	Eul
Azijn	Essieg
Mostert	Senf
Suiker	Tzoeker
Kaneel	Tziminet
Drinken	Trïnken
Ossenvleesch	Rindflaisj
Kalfsvleesch	Kalbflaisj
Schapenvleesch	Hammelflaisj
Lamsvleesch	Lamflaisj
Varkensvleesch	Sjwainflaisj
Een Kip of Hen	Ain Hoen
Een Haan	Ain Haan
Gehakt Vleesch	Gehaktflaisj
Worst	Worst
Ham	Sjienken



{==5==} {>>pagina-aanduiding<<}


Sauzijsen	Braatworst
Een Kapoen	Ain Kapaun
Een Gans	Ain Gans
Een Eendvogel	Ain End
Een Konijn	Ain Konienchjen
Een Kalfsnierstuk	Ain Nierenbraten
Een Schapenbout	Aine Kuile
Uije	Die Tziebel
Spek	Spek
Een Citroen	Ain Tzitrone
Tongen	Sjolle
Aal	Aal
Zeelt	Sjlay
Haring	Héring
Oesters	Auster
Baars	Baars
Zalm	Salm of Laks
Snoek	Hecht
Stokvisch	Stokfiesj
Erweten	Erbren
Boonen	Boonen
Aspergie	Spargel
Kool	Kool



{==6==} {>>pagina-aanduiding<<}


Zuurkool	Sauerkraut
Bloemkool	Bloemenkool
Rijst	Rais
Appelen	Affel of Eefeln
Peeren	Birn
Nooten	Nuusse
Aardappelen	Kartoefel
Booter	Botter
Vet	Sjmals
Roode Wijn	Rote Wain
Witte Wijn	Waise Wain
Brandewijn	Brendwain
Rinse Wijn	Rain Wain
Een Glas Genever of Drank	Ain Sjnabs
Water	Wasser
Tarwenbrood	Waisbrood
Roggenbrood	Sjwarsbrood
Rapen	Roeben
Melk	Mïlch
Het Ontbijt	Das Früstük
Het Middageeten	Das Mittag-essen
Het Avondeeten	Das Abend-essen



{==7==} {>>pagina-aanduiding<<}


Thee	Thee
Koffie	Kaffee
De Tafel	De Tïs
Het Tafellaken	Das Tiesjtoech
Een Servet	Ain Tellertoech
Het Zoutvat	Das Saltzfas
Een Lepel	Ain Luffel
Een Vork	Ain Gabel
Een Mes	Ain Messer
De Fles	Die Flassje
Een Bord	Ain Teller
De Schotel	Der Sjusel
Een Pan	Aine Fanne of Tiegel
Een Pot	Ain Tof
Een Ketel	Ain Kessel
Een Kom	Ain Naf
Een Kommetje	Ain Tas
Een Kopje	Ain Tas




    
{==8==} {>>pagina-aanduiding<<}

II. Godheid, Godsdienst, enz.


God	Got
De Schepper	Der Sjuffer
De Hemel	Der Himmel
De Godsdienst	Die Religioon
De Bijbel	Die Bibel
De Duivel	Der Tuivel
De Hel	Die Hulle
Het Geloof	Der Glaube
Het Christendom	Das Krïstentom
Het Jodendom	Das Joedentom
Het Heidendom	Das Heitentom
Een Christen	Ain Krïst
Een Jood	Ain Joed
Een Heiden	Ain Haide
Een Turk	Ain Tuurk
Een Huichelaar	Ain Huichler




    
{==9==} {>>pagina-aanduiding<<}

III. Van de Tijd, de namen der Maanden, Dagen en Feestdagen.


Een Jaar	Ain Jaar
Een Maand	Ain Moonat
Januarij	Jaenner
Februarij	Der Hornong
Maart	Mertz
April	Aprïl
Mei	Maij
Junij	Brachmoonat
Julij	Huimoonat
Augustus	Augoest
September	Herbstmoonat
October	Wainmoonat
November	Wïntermoonat



{==10==} {>>pagina-aanduiding<<}


December	Krïstmoonat
Een Week	Aine Wogche
Een Dag	Ain Taag
Een Uur	Aine Stond
Een Minuut	Aine Minoete
Een Ogenblik	Ain Augenbliek
De Lente	Der Frueling
De Zomer	Der Sommer
De Herfst	Der Herbst
De Winter	Der Wïnter
Zondag	Sontag
Maandag	Montag
Dingsdag	Dienstag
Woensdag	Mitwoch
Donderdag	Donnerstag
Vrijdag	Fraijtag
Zaturdag	Sonnabend of Samstag
Niewjaarsdag	Neyjaarstag
Paaschen	Ostern
Hemelvaartsdag	Der Himmelfaart
Pinkster	Fïnkster
Het Jaargetij	Die Jaartzeit



{==11==} {>>pagina-aanduiding<<}


De Morgen	Die Morgentzait
De Middag	Die Mïttagtzait
De Avond	Die Abendtzait
De Nacht	Die Nachttzait
Kers-Avond	Die Krïstnacht
Kers-Dag	Wainachten



IV. Van de Elementen, het Weder enz.


De Wereld	Die Welt
De Aarde	Die Erde
De Zee	Das Meer
Het Water	Das Wasser
De Lucht	Der Loeft
Het Vuur	Das Faier
De Zon	Die Sonne



{==12==} {>>pagina-aanduiding<<}


De Maan	Der Mond
De Starren	Die Sterne
De Wolken	Die Wolken
De Wind	Der Wiend
De Regen	Der Regen
Het Weerlicht	Der Blitz
De Donder	Der Donner
De Bliksem	Der Blitz of Donnerkail
De Hagel	Der Hagel
De Sneeuw	Des Sjnee
De Vorst	Der Frost
Het Eis	Das Ais
De Koude	Die Kelte
De Warmte	Die Werme




    
{==13==} {>>pagina-aanduiding<<}

V. Bloedverwandschap enz.


De Vader	Der Vatter
De Moeder	Die Moetter
De Grootvader	Der Grootvatter
De Grootmoeder	Die Grootmoetter
De Overgrootvader	Der Aeltervatter
De Overgrootmoeder	Die Aeltermoetter
De Voorouderen	Die Voorelter
De Zoon	Der Soon
De Dochter	Die Tochter
Het Kind	Das Kind
De Kinderen	Die Kinder
De Neef	Der Enkel, of Der Neffe
De Nigt	Die Enkelin, of Die Niechte
De Broeder	Der Broeder
De Zuster	Die Zjwester
De Oom	Der Betteai of der Ohaim



{==14==} {>>pagina-aanduiding<<}


De Moei	Die Base, die Mume
De Neef en Nigt	Gesjwesterkïnd
De Nakomelingschap	Die Nachkomensjaft
Het Huwelijk	Der Ehestand
De Bruid	Die Braut
De Bruidegom	Der Bruitegom
Een Weduwnaar	Ain Wïtwer
Eene Weduwe	Aine Wïtwe
Een Bloedvriend	Ain Verwanter
Eene Bloedvriendin	Aine Verwante
Een Vriend	Ain Fraind
Eene Vriendin	Aine Fraindïn



VI. Van den Mensch enz.


De Mensch	Der Mensj
Het Ligchaam	Der Laib



{==15==} {>>pagina-aanduiding<<}


Het Vel	Die Haut
Het hoofd	Der Kof
Het Voorhoofd	Die Stirne
Het Oog	Das Aug
Het Oor	Das Oor
Het Haar	Die Haare
De Wangen	Die Bakken
De Neus	Die Nase
De Mond	Der Mond
De Tand	Der Tzaan
De Tong	Die Tzonge
De Baard	Der Bart
De Schouder	Der Sjolter
De Rug	Der Ruken
De Hand	Die Hand
De Vinger	Der Fïnger
De Voet	Der Foes
De Gestalte	Die laibes greuse
Een Been	Ain bain
Het Gelaat	Die gestalte
De Reuk	Der geroech
De Smaak	Der gesjmak
De Ziel	Die Seele



{==16==} {>>pagina-aanduiding<<}


De Reden	Die vergnoeft
De Gedagte	Die gedanken
Het Oordeel	Das oertail
De Wil	Der wïlle
De Inbeelding	Die ainbildongskraft



VII. Van de Getallen, Maten en Gewigten.


Een	Ain
Twee	Tzwai
Drie	Drai
Vier	Vier
Vijf	Finf of Foef
Zes	Seks
Zeven	Sieben
Acht	Akt



{==17==} {>>pagina-aanduiding<<}


Negen	Nain
Tien	Tzeen
Elf	Eilf
Twaalf	Tzwulf
Dertien	Draitzeen
Veertien	Viertzeen
Vijftien	Foeftzeen
Zestien	Sekstzeen
Zeventien	Siebentzeen
Achtien	Aktzeen
Negentien	Naintzain
Twintig	Tzwantzieg
Dertig	Draitzieg
Veertig	Viertzieg
Vijftig	Voeftzieg
Zestig	Sektzieg
Zeventig	Siebentzieg
Tachtig	Aktzieg
Negentig	Naintzieg
Honderd	Hondert
Tweehonderd	Tzwaihondert
Driehonderd	Draihondert
Vierhonderd	Vierhondert



{==18==} {>>pagina-aanduiding<<}


Vijfhonderd	Fünfhondert
Duizend	Tauzend
Een Geheel	Ain Gantz
Een Half	Ain Halb
Een Vierde	Ain Viertel
Een Achtste	Ain Halb Viertel
Een Pond	Ain Fond
Een Half Pond	Ain Halb Fond
Een Kwart Pond	Ain Viertel Fond
Een Achtste Pond	Ain Halb Viertel Fond
Een Once	Tzwai Loot
Een Lood of Half Ons	Ain Loot
Een El	Ain Staab
Een Vadem	Ain Klaster
Een Pint	Ain Nutsel




    
{==19==} {>>pagina-aanduiding<<}

VIII. Klederijen, enz.


Het Kleed	Das Klaid
De Hoed	Der Hoet
De Muts	Die Mutze
De Paruik	Die Paruke
De Das	Der Halstoech
De Mantel	Der Mantel
De Kraag	Der Ubersjlaag
Het Vest of Kamisool	Die Weste of das Kamisool
De Broek	Die Hoose
De Kousen	Der Strumfe
Het Hemd	Das Hemd
De Mouw	Der Ermel
De Opslagen	Die Aufsjlage
De Zak	Die Tas-Je
Een Knoop	Ain Knof
Een Knoopsgat	Ain Knofloch



{==20==} {>>pagina-aanduiding<<}


Handschoenen	Handsjoe
Een Zakdoek	Ain Sjnoeftoech
De Kousebanden	Die Stromfbender
Gespen	Sjnallen
Een Horlogie	Ain Zak-Oer
De Laarsen	Die Stiefeln
Een Laarsenknegt	Ain Stiefelknegt
De Schoenen	Die Sjooë
Een Keurslijf	Ain Sjnoerlaib
Een Boezelaar	Ain Sjürte of Voortoech
Een Snoer	Ain Sjnoer
Paarlen	Perlen
Een Ketting	Aine Kette
Oorringen	Das Orengehenk
Een Speld	Aine Sjteknadel
Een Naald	Aine Neenadel
Het Garen	Des Tzwïrn
Blanketsel	Die Sjminke
Lijnwaad	Die Lainwand
Zijde	Saide
Wol	Wolle
Laken	Toech



{==21==} {>>pagina-aanduiding<<}


Een Parasol	Ain Sonnen Sjirm
Parapluie	Ain Regensjirm of Paraplu
Een Schuijer of borstel	Aine Büste
Een Schoenborstel	Aine Büste



IX. Huizen en Gestichten Derzelver Deelen, enz.


Een Paleis	Ain Palast
Een Kasteel	Ain Sjlos
Een Huis	Ain Haus
De Deur	Die Tuer
Het Slot	Das Sjlotz
De Sleutel	Der Sjlusel
De Grendel	Der Riegel
De Schel	Die Sjelle
Een Zaal	Ain Saal



{==22==} {>>pagina-aanduiding<<}


Een Kamer	Ain Kammer
Een Vertrek	Ain Tzïmmer
Een Kagchelkamer	Ain Stoebe
Een Kagchel	Ain Ofen
De Plaats	Der Hof
De Keuken	Die Küche
De Kelder	Der Keller
Het Koetshuis	Die Sjoepen
Het Sekreet of Gemak	Der Abtrit of Kommoditeet
De Trap	Die Treppe of Stiege
De Zolder	Der Boden
De Vloer	Der Boden
Het Dak	Das Tach
De Schoorsteen	Die Faiermauer
De Muur	Die Mauer
De Balken	Die Balken
De Gang	Der Gang
De Steenen	Die Staine
De Haard	Der Heerd
Een Kast	Ain Sjrank
De Vensters	Die Fenster




    
{==23==} {>>pagina-aanduiding<<}

X. Meubelen en huizelijke gereedschappen.


Een Tafel	Ain Tiesj
Een Tapyt	Ain Teppiech
Een Spiegel	Ain Spiegel
Een Stoel	Ain Stoel
Een Stoelkussen	Ain Polster
Een Staand-Horlogie	Ain Wandoer
Een Kandelaar	Ain Laichter
Een Snuiter	Aine Liechtpoetze
Een Vat	Ain Gefaes
Een Schop	Ain Schaufel
Een Bed	Ain Bet
De Gordijnen	Die Voorhenge
Een Matras	Ain Stroosak
Een Pot	Ain Tof of Hafen
Een Braadspit	Ain Braatspies



{==24==} {>>pagina-aanduiding<<}


Een Ketel	Ain Kessel
Een Pan	Ain Tiegel
Een Rooster	Ain Rost
Een Emmer	Ain Wasseraimer
De Vijzel	Der Mursel
Een Vat	Ain Fas of Gefaes
Een Vaatje	Ain Faeslain
Een Kurketrekker	Ain Korktzieër
Turf	Torf
Hout	Holtz
De Tang	Die Tzange
De Aschschop	Die Akssjaufel
Zwavelstokken	Sjweefel Holtzlain
De Blaasbalg	Der Blasebalg
Vaatwerk	Das Kuechen gesjïr
De Zeef	Der Sieb
Een Melkpot	Ain Mïlch Tof of Gefaes
Kaarsen	Das Liecht
Een Lamp	Aine Lampe
Een Lantaarn	Aine Laterne.




    
{==25==} {>>pagina-aanduiding<<}

XI. Kantoor-Zaken, enz.


De Lessenaar	Die Polt
Het Papier	Das Papier
De Pennen	Die Feeder
Een Pennemes	Ain Feedermesser
De Ink	Die Dïnte
De Inkkoker	Das Dïntegefees of Sjraibtzuig
Kantoor-Zand	Struisand
De Zandkoker	Die Zandboekse
Een Potlood	Ain Blaistift
Een Lineaal	Ain Lineaal
Een Passer	Ain Tzïrkel
Waschlicht	Das Waksliecht
De Regel	Die Tzaile
Een Riem Papier	Ain Rais Papier
Een Vel Papier	Ain Boge Papier
Een Blad van een Boek	Ain Blat



{==26==} {>>pagina-aanduiding<<}


Een Bladzijde	Aine Saite
Het Boek	Das Boech
De Rand	Die Rand
Overzetten, Vertalen	Uberzetzen
Een Cachet	Een Petsjaft
Lak	Siegelwaks
Ouwelen	Obletter
Een Zegel	Ain Siegel
Een Omslag	Ain Omsjlag
Een Getal	Ain Tzaal
Een Brief	Ain Brief
Een Briefje	Ain Tzettel
Een Cijffer	Ain Tzieffer
Rekenen	Rechnen
Schrijven	Sjraiben
Aantekenen	Notiren
Bankroet maken	Bankroet geëen




    
{==27==} {>>pagina-aanduiding<<}

XII. Muziek-Instrumenten, enz.


De Muziek	 Die Moesiek
Een Viool	Ain Gaige
Een Bas	Ain Bas
Den Strijkstok	Der Fiedelbogen
De Snaren	Die Saiten
De Kam	der Steg
Een Klavecijmbaal	Ain Klavier
Een Fluit	Aine Fleute
Een Dwarsfluit	Ain Kwerfleute
Een Trompet	Aine Trompette
De Pauken	Die Pauken
Een Guitar	Aine Tzïtter
Een Harp	Ain Harfe
Een Orgel	Aine Orgel
Een Trommel	Aine Trommel
Een Klarinet	Aine Clarinette
De Dans	Der Tantz



{==28==} {>>pagina-aanduiding<<}


De Zang	Der Gezang
De Stem	Die Stïmme
Een Lied	Ain Lied
De Wijs	Die Melodie
Muziek maken	Moesisieren



XIII. Regeringsmagten, Oorlogs-Wapenen, enz.


De Oorlog	Der Krieg
Een Keizer	Ain Kaizer
Een Keizerin	Aine Kaizerïn
Een Koning	Ain Keunïg
Een Koningin	Aine Keunigïn
Een Prins	Ain Prins
Een Prinses	Aine Princesse
Een Vorst	Ain Fürst
Een Generaal	Ain Generaal



{==29==} {>>pagina-aanduiding<<}


Een Generaal-Majoor	Ain Feldwachtmaister
Een Majoor	Ain Oberwachtmaister
Een Kapitein	Ain Hauptman
Een Luitenant	Ain Onterhauptman
Een Vaandrig	Ain Feendrïg
De Kapitein des Arms	Der Feenjonker
De Foerier	Der Rechnongsfürer
Een Ritmeester	Ain Ritmaister
Een Korporaal	Ain Rotmaister
Een Ruiter	Ain Raiter
De Prevoost	Der Stokmaister
Het Leger	Das Lager of das Kriegsher
De Infanterie	Das Füsvolk
De Kavallerie	Die Raitery
De Voorhoede	Die Voorträb
De Achterhoede	Die Nachträb
Een Regiment	Ain Regiment
Een Kompagnie	Aine Fäne
De Veldtogt	Der Feldzoeg



{==30==} {>>pagina-aanduiding<<}


De Aftogt	Der Rüktzoeg
Het Piket	Die Feldwagcht
Het Geschut	Das Gesjütz
Een Mortier	Ain Murser
Verdedigen	Vertaitigen
De Loopgraven	Die Laufgraben
Ondermijnen	Ontergraaben
De Amunitie	Die Kriegsbedurfüïs
Het Garnisoen	Die Besetzong
Het Gelid	Das Glied
Een Tamboer	Ain Trommelsjlager
Een Pijper	Ain Faiffer
De Tamboer-Majoor	Der Regiment Trommelsjlager
De Ronde	Die Ronde
De Patroulje	Die Patrolle
De Taptoe	der Tzaffenstraich
Een Spion	Ain Kondsjafter of Spion
Een Zoetelaar	Ain Marketenter
De Wapenen	Die Waffen
Een Degen	Ain Degen
De Kling	Die Klïnge



{==31==} {>>pagina-aanduiding<<}


De Sabel	Der Saebel
Het Geweer	Das Geweer
Een Kogel	Ain Koegel
Een Piek	Ain Spies
Een Bombe	Aine Bombe
Een Bagagiewagen	Ain Pakwagen
Een Tent	Ain Tzelt
De Wapenen Veroveren	Das Geweer verspregchen
De Doortogt	Der Doerchtzoeg
Eene Escorte	Ain Gelait
De Belegering	Die Belagerong
Het Alarm	Die Lermen
De Overwinning	Die Sieg
De Nederlaag	Die Niederlage
De Soldij	Das Sold
De Inkwartiering	Die Ainkwartirong
Een Paspoort	Ain Geleitsbrief
De Schildwagt	Die Sjïldwacht
De Trommel Slaan	Die Trommel rüren
De Reveille Slaan	Die Revel sjlagen
Ontwapenen	Entwafnen
Werven	Werben



{==32==} {>>pagina-aanduiding<<}


Op de Wagt Trekken	Auf die Wacht tzieen
Uittrekken	Austzieen
Een Kazemat	Ein Moordkeller
Een Batterij	Ein Stuukbet
De Bres	Der Walbroech
De Kapitulatie	Die handlong tzoer übergabe



XIV. Landen, Volkeren, enz.


Holland	Holland
Een Hollander	Ain Hollaender
Duitschland	Duitsjland
Een Duitscher	Ain Duitsjer
Pruischen	Pruissen
Een Pruis	Ain Pruis
Oostenryk	Oesteraich
Een Oostenryker	Ain Oesteraicher
Zweden	Sjweeden



{==33==} {>>pagina-aanduiding<<}


Een Zweed	Ain Sjweed
Zwitserland	Der Sjwais
Een Zwitser	Ain Sjwaitzer
Denemarken	Daenemark
Een Deen	Ain Daene
Turkye	Die Türkay
Een Turk	Ain Tuurk
Barbarye	Die Barbaray
Frankryk	Frankraich
Een Franschman	Ain Fransoos



XV. Men vindt op het Land of in de Stad


Een Berg	Ain Berg
Een Dal	Ain Taal
Een Woud	Ain Wald
Een Weide	AinViewaide
Een Hooiland	Aine Wiese
Een Brug	Aine Brücke



{==34==} {>>pagina-aanduiding<<}


Een Stroom	Ain Floes
Eene Beek	Aine Bach
Een Meer	Aine See
Een Schuit	Ain Sjieflain
Een Vlek	Ain Flekke
Een Dorp	Ain Dorf
Een Sloot	Ain Graben
Een Straat	Aine Strasse of Gasse
Een Tooren	Ain Toerm
Een Kerk	Aine Kïrche
Een Gasthuis	Ain Spitaal
Het Gevangenhuis	Das Gefengnies
Een Stadhuis	Das Raathaus
Een Herberg	Aine Herberge
Een Kroeg	Ain Wirthaus
Een Molen	Aine Müle
Eeu Sluis	Aine Sjluise




    
{==35==} {>>pagina-aanduiding<<}

XVI. Rijtuig, Stalgereedschap enz.


Een Koets	Aine Koetsje
Een Wagen	Ain Wagen
Een Kar	Ain Karren
Het Paard	Das Ferd
Een Grijs Paard	Ain Grausjimmel
Een Vos	Ain Foeehs
Een Trekpaard	Ain Tzoegferd
Een Hengst	Ain Hengst
Een Ruin	Ain Wallach
Een Merrie	Ain Stoete
Een Veulen	Ain Fülen
De Kreb	Die Krippe
Hooi	Hui
Stroo.	Stroo
Haver	Haber
De Roskam	Der Striegel
De Eetkorf	Der Maulkorb



{==36==} {>>pagina-aanduiding<<}


De Hoefijzers	Die Hoefaisen
Het Bit of Gebit	Das Gebïs
De Stangen	Die Stangen
De Teugel	Die Tzügel
De Borstriem	Der Broestriemen
Het Hoofdstel	Das Hauptgestel
Een Schabrak	Ain Sjabrak of Satteldekke
Een Zadel	Ain Sattel
Een Toom	Ain Tzaum
De Staartriem	Der Sjwansriemen
De Halster	Die Halster
De Stijgbeugels	Die Staigbügel
De Zweep	Die Paitsje
De Spooren	Die Spooren
De Stal	Die Stalle
De Koetsier	Der Koetsjer
De Stalknegt	Der Stalknegt




    
{==37==} {>>pagina-aanduiding<<}

XVII. Metalen, Verwen enz.


Goud	Gold
Zilver	Silber
Koper	Koeffer
Tin	Tzin
Yzer	Aisen
Geel Koper	Messing
Staal	Staal
Blik	Aisen Blech
Zwart	Sjwarts
Wit	Wais
Blaauw	Blau
Rood	Root
Oranje	Pommerantzenfarb
	Orange
Geel	Gelb
Groen	Grün
Grijs	Grau
Bruin	Braun
Paers	Violet.




    
{==38==} {>>pagina-aanduiding<<}

XVIII. Handwerken, Beroepen enz.


Een Predikant	Ain Farrer
Een Advocaat of Procureur	Ain Sachwalter
Een Taalmeester	Ain Sprachmaister
Een Koopman	Ain Kaufman
Kooplieden	Kaufluite
Een Makelaar	Ain Makler
Een Boekdrukker	Ain Boechdrokker
Een Graveur	Ain Koeferstegcher
Een Boekbinder	Ain Boechbinder
Een Boekverkooper	Ain Boechhendler
Een Landbouwer	Ain Akkerman of Bauer
Een Molenaar	Ain Müler
Een Bakker	Ain Baeker
Een Brouwer	Ain Brauer
Een Arts	Ain Arts, Doctoor



{==39==} {>>pagina-aanduiding<<}


Een Aptheker	Ain Apoteeker
Een Chirurgyn of Heelmeester	Ain Wondarts
Een Barbier	Ain Balbierer
Een Slager	Ain Metsjer, Flaisjer
Een Timmerman	Ain Tzimmerman
Een Metzelaar	Ain Maurer
Een Schilder	Ain Maaler
Een Glazemaker	Ain Glaser
Een Daglooner	Ain Arbaiter
Een Kuiper	Ain Fasbinder of Küfer
Een Tuinman	Ain Gertner
Een Hoedenmaker	Ain Hüter of Hoetmagcher
Een Jager	Ain Jaeger
Een Koperslager	Ain Koefersjmit
Een Schoenmaker	Ain Sjoester
Een Kleeremaker	Ain Sjnaider
Een Zwaardveger	Ain Sjwertfeeger
Een Smit	Ain Sjmit
Een Zadelmaker	Ain Satler
Een Horlogiemaker	Ain Oermagcher



{==40==} {>>pagina-aanduiding<<}


Een Wagenmaker	Ain Wagner
Een Yzerkooper	Ain Aisenhendler
Een Visscher	Ain Fiesjer
Een Bondwerker	Ain Kürsjner
Een Kramer	Ain Kraemer
Een Mandemaker	Ain Korbmagcher
Een Kok	Ain Koch
Een Musikant	Ain Moesikant
Een Aanspreker Bidder, Nooder	Ain Laichenbitter



XIX. Viervoetige Dieren.


Het Paard	Das Ferd
De Koe	Die Koe
De Os	Der Ochs
Het Kalf	Das Kalb
Het Schaap	Das Sjaaf
Het Varken	Das Sjwain
Een Ezel	Ain Ezel



{==41==} {>>pagina-aanduiding<<}


Een Aap	Ain Af
Een Bok	Ain Bok
Een Geit	Ain Tziege
Een Wilde Geit	Ain Gemze
Een Buffel	Ain Boeffel Ochs
Een Beer	Ain Baer
Een Hert	Ain Hirsj
Een Rhee	Ain Rëe
Olijphant	Ain Elefant
Een Leeuw	Ain Leuwe
Een Wild Varken	Ain Eber
Een Kameel	Ain Kameel
Een Jong Varken	Ain Friesjling
Een Hond	Ain Hond
Een Kat	Ain Katze
Een Egel	Ain Igel
Een Haas	Ain Haase
Een Konijn	Ain Konïncken
Een Speenvarken	Ain Spaanferkel
Een Hazewindhond	Ain Windspiel
Een Ram	Ain Widder
Een Tijger	Ain Tieger




    
{==42==} {>>pagina-aanduiding<<}

XX. Vogelen.


Vogelen	Veugeln
Een Haan	Ain Haan
Een Hen	Aine Henne
Een Duif	Ain Taube
Een Kuiken	Ain Küchlein
Een Paauw	Ain Fau
Een Gier	Ain Gaijer
Een Raaf	Ain Rabe
Een Kuikendief	Ain Waie
Een Arend	Ain Adler
Een Koolmees	Aine Maise
Een Eendvogel	Ain Entvogel
Een Gans	Aine Gans
Een Kraai	Aine Kraëe
Een Kanarie	Ain Kanarien Vogel
Een Lijster	Aine Drossel
Een Fasant	Ain Fasan



{==43==} {>>pagina-aanduiding<<}


Een Vink	Ain Fink
Een Koekkoek	Ain Koekkoek
Een Nagtegaal	Aine Nachtigaal
Een Goudvink	Ain Goldvink
Een Pelikaan	Ain Pelikaan
Een Papegaai	Ain Papegay
Een Snip	Aine Sjneffe
Een Zwaan	Ain Sjwaan
Een Ojevaar	Ain Storch
Een Spreeuw	Ain Staar
Een Mosch	Ain Sperling



XXI. Kruipende Dieren en Insecten.


Een Kikvorsch	Ain Frosj
Een Slang	Aine Sjlange
Een Hommel	Aine Hommel
Den Bloedzuiger	Ain Bloetigel



{==44==} {>>pagina-aanduiding<<}


De Beien	Die Bienen
Een Slak	Aine Sjnekke
Een Luis	Ain Laus
Een Vloo	Ain Floo
Een Schildpad	Aine Sjildkreote
Een Spinnekop	Aine Spinne
Een Rups	Aine Raupe
Een Mug	Aine Mükke
Een Mier	Aine Amaise
Een Vlieg	Aine Fliege
Een Worm	Ain Worm



XXII. Vragen en Antwoorden, veel Voorkomende Gezegdens, enz.


Welkom hier	Sind sie welkomme
Ga binnen	Geëen sie herain



{==45==} {>>pagina-aanduiding<<}


Hoe laat wilt gij Eeten	Wie speet wollen sie spaisen
Ik zal het halen	Iech werde es holen
Hebt gij goed Geslapen	Haben sie wool gesjlaffen
Het is mijn schuld niet	Es ist maine sjold niecht
Het heeft geen nood	Es hat kain sjwirïgkait
De klok slaat gij moet na de wagt	Die stonde sjlaegt si musen nach der wacht
Gij hebt nog tijd over	Sie haben noch tzait übrïch
Hoe veel mijlen hebt gij van daag afgelegt	Wie viele mailen haben sie huite tzoeruk geleget
Gij hebt een moeilijke reis gehat	Sie habe ain musame raise gehabt
Dat gaat nog al	Das geet nog wool an
Gij hebt meer gehadt als noodig was	Sie haben meer gehabt als neutig waer



{==46==} {>>pagina-aanduiding<<}


Gij drinkt te veel	Sie trïnken tzoe viel
Gij zijt dronken	Doe bïst besoffen
Ik twijfel zeer	Ich tzwaifle seer
Gij zult het wel zien	Sie werden es sjoon siëen
Ik verlaat mij daarop	Ich verlasse miech daar auf
Waarlijk	In waarhait
Omtrent	Etwan
Bijna	Etwo
Elk een	Jederman
Gij zult meer hebben	Sie werden meer bekommen
Hoe wordt dat in het Duitsch Genoemd?	Wie hais das auf duitsj
Ik ben u zeer verplicht	Ich bin inen seer verbonden
Wilt gij met mij gaan	Wollen sie met mier geëen
Gij zijt hier vreemd	Sie sind hier fremd
Van waar komt gij	Wo kommen sie her



{==47==} {>>pagina-aanduiding<<}


Zijt gegroet of adieu goede vriend	Adjee goete fruind
Vaarwel	Leeben si wool
Goede morgen	Goeten morgen
Goede avond	Goeten abend
Tot wederziens	Tzoem wiederseëen
Ik wensch u alle goeds	Iech wunsje dïer alles goetes
Wat zal dat zijn	Wat sol das sain
Wat dunk u daarvan	Was dünket uich davon
Wat belieft u	Was bliebt inen
Waarom zoo veel omslag	Waarom soo viel weezens
Is het waar dat….?	Ies es gewïs das….?
Waartoe zal of zou dat dienen	Wortzoe sol of wurde das dienen
Waar mee houdt gij u bezig	Wormit besjeeftigen sie siech
Wel te rusten	Angneeme roëe of sjlaffen zie wool
Laat mij met vreden	Las miech tzoe frieden



{==48==} {>>pagina-aanduiding<<}


Het doet mij leed	Es ïs mier laid
Loop bemoei u met uw zaken	Gee noer ord warte uirer sagchen
Gaa mij uit den weg	Gee mier aus den augen
Dat is onverdraaglijk	Es ïst niecht aus zoesteën
Ik verbiede u dat	Iech verbïte uich das
Zwijg	Halt das maul
Kom daar niet aan	Ruur das niecht an
Ik verbiede het u nog eens	Iech verbiete es dier noch ainmaal
Om Godswil doe het toch niet 	Om Gottes wïllen toe es ja niecht
Wacht u wel zulks te doen	Seëet uich wool voor, das ier das niecht toet
Wacht u daar voor	Hütet uich daar voor
Dat is ten strengste verboden	Das ïst auf laiben strafe verboten
Spreek met mij	Reeden sie mit mier
Zeer gaarne	Gants gern



{==49==} {>>pagina-aanduiding<<}


Waar is u kameraad	Wo ïst irer kameraad
Hier digt bij	Hier allernaegst
Gij zult mij veel plaisieren	Sie werden mier ain grose gefaelle thoen
O ja waarom niet	Ach ja waarom niecht
Ik vraag excus, vergeef mij, neem mij niet kwalijk	Vettzaien sie miech, iech bït om vergebong neemen simier niecht übel
Het is onnodig	Es bedarft nicht
Hoe zoo?	Wie zo?
Kleed u schielijk aan	Gesjwïnd tziëen sie siech an
Ik zal zoo klaar zijn	Ich werde zoo glaich fertig sain
Zult gij het niet weer doen	Werden sie es niecht meer toen



{==50==} {>>pagina-aanduiding<<}


Hio vaart gij sedert gisteren	Wie befinden sie sich tzait gistern
Zeer wel	Gantz wool
Ik Bedank u	Ich danke inen
Ga Zitten	Setzen sie sich nieder
Het is Mooi Weer	Es ïst recht sjeun wetter
Het is Koud	Es ïst kalt wetter
Hoe Laat is het reeds?	Wie spaet ïst es sjoon?
Het is Elf Uur	Es ïst eilf oer
Hebt gij geen Horlogie	Haben sie kain oer of zak-oer
Wilt gij Eeten	Wollen sie essen
Wilt gij Drinken	Wollen sie trïnken
Daar hebt gij een Glas Genever	Da haben sie ain sjnabs
Hebt gij veele batailles bij gewoond?	Sind sie sjoon bai viele faldsjlagen geweesen?
Hij is dikwijls met groot verlies geretireerd	Er ist viermaal mit bloetigen kof davon gekommen



{==51==} {>>pagina-aanduiding<<}


Hij heeft het lang uitgehouden	Er hat lange tzait die kof empoor gehalten
De couranten liegen meest	Die tzaitongen luugnen wieder gedrokt
Hij loopt in de kaars	Er wird anlaufen
Het begint er nu goed naar te gelijken	Es sjikt siech alles datroe an
Uit het oog, uit het hart	Aus den augen, aus den sin
Die de kelk heeft zegend zich	Der das kruis hat seegnet siech selbst am ersten
Men moet de tering naar de nering schikken	Man moes siech nach der dekke strekken
Ik zal u beenen maken	Iech werde uich fuse magcken
Gij pijnst	 Sie sind in tiefen gedanken
Zoo gaat het in de wereld	Alzoo geet es in der welt



{==52==} {>>pagina-aanduiding<<}


Geld is de ziel van alle zaken	Geld ist die loosong
Het komt mij niet gelegen	Es ist mier niecht leegen
Gij raakt mijne eer aan	Doe grayfet maine eere an
Iets beloven	Etwas verspregchen
Gij hebt goed spreken	Ier hatst goet sagen
Wat legt er aan gelegen	Was liegt daaran
Een vrolijke gast	Ain loestiger broeder
Hij is een gek	Er ist ain nar
Zijt gij dwaas	Bist doe nerriesch
Men zegt	Es haist
Het is haast gedaan	Es werd bald am ende sain
Hals over kop	Uber kof ond hals
Bij ja en neen	Bai ja ond nain
Het is uit	Es ist ausgemacht

    
NB. Tot supplement dezes is bij den Uitgeever ter perse, Alphabetische verzameling van Hoog- en Nederduitsche woorden, naar de uitspraak in het Hollandsch gespeld.



* Dank zij de bescherm-geest onzer half verfranschte moedertaal, dat men op dergelijke invallen voor jaren niet gekomen is; anders ware Holland enz. in een Babel verandert.

† Hier van is reeds genoeg voorhanden.

