
   
        
           
               De kleine Russische taalmeester. Een nood- en hulpboekje voor Hollanders, die zich met deze taal eenigzins willen bekend maken
           
           
               
                   Dit bestand biedt, behoudens een aantal hierna te noemen ingrepen, een diplomatische weergave van de tweede druk van De kleine Russische taalmeester. Een nood- en hulpboekje voor Hollanders, die zich met deze taal eenigzins willen bekend maken uit 1814. De eerste druk dateert uit 1813. Er is gebruik gemaakt van een door Stichting Vrijwilligersnetwerk Nederlandse Taal o.l.v. Nicoline van der Sijs en Hans Beelen aangeleverd bestand.
               
               
                   
                       
                   
               
           
           
           
               _kle014klei02_01
               DBNL-TEI 1
               
                   2021 dbnl
               
           
           
               
           
           
               
                   
                   exemplaar Universiteitsbibliotheek Amsterdam, signatuur: UBM: 1996 E 4, scan van Google Books
               
               De kleine Russische taalmeester. Een nood- en hulpboekje voor Hollanders, die zich met deze taal eenigzins willen bekend maken. J.A. Meyboom, Amsterdam 1814 (tweede druk)
               
           
       
       
           
               Wijze van coderen: standaard
               
           
       
       
           
               Nederlands-Russian
           
       
       
           
               De kleine Russische taalmeester. Een nood- en hulpboekje voor Hollanders, die zich met deze taal eenigzins willen bekend maken
               
               
               
                   
                   
                   
               
           
           
           
           
               
           
           
               
               
           
           
           
           
       
       
           
               De kleine Russische taalmeester. Een nood- en hulpboekje voor Hollanders, die zich met deze taal eenigzins willen bekend maken
               
               
               
                   
                   
                   
               
           
           
           
           
               
           
           
               
               
           
           
           
           
       
       
           
               2021-01-15
               
                   RK
               
               colofon toegevoegd
           
       
   

Verantwoording 

Dit tekstbestand is gebaseerd op een bestand van de Digitale Bibliotheek voor de Nederlandse Letteren (https://www.dbnl.org)

Bron: De kleine Russische taalmeester. Een nood- en hulpboekje voor Hollanders, die zich met deze taal eenigzins willen bekend maken. J.A. Meyboom, Amsterdam 1814 (tweede druk)
 
Zie: https://www.dbnl.org/tekst/_kle014klei02_01/colofon.php

In dit bestand zijn twee typen markeringen opgenomen: paginanummering en illustraties met onderschriften. Deze zijn te onderscheiden van de rest van de tekst door middel van accolades: {==13==} {>>pagina-aanduiding<<} {==Figuur. 1: Onderschrift van de afbeelding.==} {>>afbeelding<<} 






{==1==} {>>pagina-aanduiding<<}

DE
KLEINE RUSSISCHE
TAALMEESTER.

EEN
NOOD- en HULPBOEKJE
voor
hollanders,
Die zich met deze taal eenigzins willen bekend maken.

tweede druk.

Te AMSTERDAM, bij
J. A. MEYBOOM.
Op de Keizersgracht, bij de Brouwersgracht.




{==2==} {>>pagina-aanduiding<<}

Voorberigt.

Uit gebrek aan Russische Letters, en daar dezelve ook tot nog toe, over het algemeen in Holland niet kunnen gelezen worden, hebben wij hier de bekende latijnsche letteren in plaats van de russische gebruikt: Ook hebben wij deze letters niet volgens de ortographie, maar naar de uitspraak en klank der woorden, zoo als dezelve in de russische taal uitgesproken worden, in dit boekje geplaatst.




{==3==} {>>pagina-aanduiding<<}

Inhoud.


I.	Spijs en drank.
II.	Geldspecie, getallen en schrijfbehoeften.
III.	Van den Tijd, namen der Maanden, en dagen, als ook van eenige feestdagen.
IV.	Kleeding en verschooning.
V.	Kleuren.
VI.	Krijgswoorden en benamingen.
VII.	Over de Muzijk.
VIII.	Gewone zamenspraken.
IX.	Klein hollandsch en Russisch woordenboekje.





{==4==} {>>pagina-aanduiding<<}

Van spijs en drank.


Het eten	Koehsehanie
Het ontbijt	saftrak
Het Middageten	Abahd
Het avondeten	Oehskin
Brood	Chleb
Vers brood	Maegkih chleb
Witte brood	Baehloi Chleb
Rogge brood	Rschannii Chleb
Kaas	Sir
Een Stuk	Koesok
Een Stuk Kaas	Koesok sira
Room	Stzlihwki
Melk	Malackoh
Aardappels	Simijacke
Een Appel	Jaebloko
Oranje Appel	Pomerahnetz
Een Peer	Groehscha
Een Vijg	Wihrnaja jahgoda
Meloenen	Duhnae
Een Noot	Orech
Een Walnoot	Grehtzkoi Orech
Pruimen	Stzliwa, weschnis
Rozijnen	Isoehm
Druiventros	Winograhd
Boschbeziën	Tschornihka
Komkommers	Agverhetz



{==5==} {>>pagina-aanduiding<<}


Ramenas	Chren
Radijs	Rehtha
Een Raap	Repha
Aspergie, Spergie	Stzpahrsha
Selderij	Stzeldereae
Spenasie	Schpinath
Ajuin, Uije	Loeck
Peterselie	Petroehschka
Knoflook	Tschesnok
Linzen	Tschezewitza
Mostaart, Mostert	Gartschitztza
Soep	Stzoep
Groene soep	Schtschi
Erwten	Garoch
Boonen	Babih
Boekweite grutten	Gnehschnewaja kroejoh
Gepelde garst	Jetschmehnnaja kroepih
Gierst, geerst	Prohstzo
een Eij	Jeitzoh
Eijer koeken	Jeischnitsa
harde Eijeren	Goestiha jeitzi
weekgekookte eijeren	Jeitzeh, w’szmaetka
Gebak	Pirohshnoe
Oly	Mahstzlo
Boter	Karowie maslo
Sop, Zous, doop	Stzoustz
gebraad	Scharko
Vleesch	Maehstzo
gerookt Vleesch	Koptschoehn naja gawaehdina
Pekel Vleesch	Stzolonina



{==6==} {>>pagina-aanduiding<<}


Rundvleesch	Gawaehdina
schapenvleesch met knollen	Laehschka Barehninae
kalfsvleesch	Telaehtina
varkens vleesch	Stzwinihna
ham	Ohkarok
spek	Wetsehinah
Worst	Kolbas
bloedworst	Kalbastzah
braadworst	Stzostziski
een Endvogel	Oetka
een Gans	Goestz
een haan	Petoech
een kalkoensche haan	Indeistz koi petoech
een hoen	Koehritza
eenige kippen	Tziplaehta
een kapoen	Kaploehn
een Lijster, kraanvogel	Stzchroi drosd
een Patrijs	Koerapahtka
duiven	Goloebs
Merg	Mosgh
Zalm	Stoehmga
Aal	Oegor
Oesters	Oehstritza
haring	Stzeld
snoek	Schtschoeka
een Kreeft	Rak
Steur	Ostzehir
Stokvisch	Troeskah
Spiering	Kohroeschka
water	Woda



{==7==} {>>pagina-aanduiding<<}


Wijn	Winoh
Roode wijn	Kratzna winoh
witte wijn	Baehloi win
Brandewijn	Wotka
bier	Pihma
Azijn	Oekstsoetsz
Gember	Inbihr
Kaneel	Korihtza
Zuijker	Stzachar
Visch	Ribi
drank	Napihtok
Peper	Pehretz
de Peperbosch	Iehreschnetztza
Zout	Stzol
het zoutvat	Stzolahnka, stzolonihtza
het bord	Tarehlka
het Servet	Stzalfehtka
Thee	Tschai
Tabak	Toback
Een Tabaksdoos	Tobakirka
Een Flesch	Boethilka



2. Geldspecie, Getallen en Schrijfbehoeften.


Geld	Dengi
Goud	Soloto
Zilver	Serebro
Kopergeld	Mednie dengi
Een daalder	Taler



{==8==} {>>pagina-aanduiding<<}


Een gulden	Goelden
Een	Odin
Twee	Dwa
Drie	Tri
Vier	Tschetheri
Vijf	Paeht
Zes	Schest
Zeven	Stzem
Acht	Wohstzem
Negen	Dehwet
Tien	Desjat
Elf	Odinatzal
Twaalf	Dwenatzal
Dertien	Trinatzal
Veertien	Tschetherinatzal
Vijftien	Paehtnatzal
Zestien	Schestnatzal
Zeventien	Stzemnatzal
Achtien	Wohstzemnatzal
Negentien	Dewetnatzal
Twintig	Dwatzat
Een en twintig	Dwatzat odin
Twee en twintig	Dwatzat dwa
dertig	Tritzat
Veertig	Stzohrok
Vijftig	Paehtdestzet
Zestig	Schest destzet
Zeventig	Stzemdestzet
Tachtig	Wohstzemdestzet
Negentig	Dewaenosto
Honderd	Sto



{==9==} {>>pagina-aanduiding<<}


Twee honderd	Dwaesti
Drie honderd	Trista
Vier honderd	Tscheteristza
Zes honderd	Paeht-stzot
Zeven honderd	Schest sot
Duizend	Tistzatscha
Tienduizend	Tma
Papier	Boemaga
Vloeipapier	Propoestzknaja boemaga
Een boek	Kniga
Een zakboekje	Sapistznaja kniga
Een boek papier	Dehst
Een blad	Lineijka
Een klein blaadje	tschetwehrka, bistot schik
Een pagina	Strannihtza
Een regel	Strokah
Een brief	Piszno
Een kwitantie	Rastzpiska
Een Rekening	Stztsehot
Het pergament	Pergahmin
Lezen	Tschitat
Onderteekenen	Podpistzat, roekoe priloshit
Uitstrijken, uitvegen	Wihtschernit
Een overzetting	Perowod
Een omslag	Obwortka
Een rand	Pohle na stranihtze
Een schrijftafel	Boero, kabinet
Inkt	Tschernila
Inktkoker	Tschernilitza



{==10==} {>>pagina-aanduiding<<}


Potloot	Karandasch
Krijt	Mjel
een pen	Pero
een Pennemes	Perotschinnoij noshik
een kachet	Petschat
Zegellak	Stzoergoetsch
Strooizand	Pestzok
een zandkoker	Pestzoschnitza
een passer	Tzirkoel
de Schaar	Nohshnitzi
een Lineaal	List



3. Van den Tijd, Naamen der Maanden, en Dagen, als ook van eenige Feestdagen.


De tijd	Wremja
Heden	Sewodnja
morgen	Savera
gisteren	Wetschera
Voorgisteren	Trehljaewodni
Overmorgen	Postjasavtra
Een Uur	Tschas
Een Oogenblik	Mgnowehnie ohka
De Ochtend	Oehtro
De Middag	Pohlden
De Avond	Wehtscher
De Nacht	Notsch
De Middernacht	Pohlnotsch
De Morgenstond	Rasweth



{==11==} {>>pagina-aanduiding<<}


De Dag	Denn
De Week	Nedehlae
De Maand	Mehsetz
Het Voorjaar	wesnah
De Zomer	Lehto
De Herfst	Ohsen
De Winter	Simah
Het Jaar	God
De ondergang der zon	Sahehosch denie schlniza
Hoe laat is het?	Kotoroi Tschas?
Het is laat	Otschen posto
Het is één uur	Pervoi Tschas
Januarij	Genwahr
Februarij	Fewrahl
Maart	Mart
April	Aprehl
Mei	Mai
Junij	Jjoehn
Julij	Jjoehl
Augustus	Awgoest
September	Stzentaehbr
October	Oktaehbr
November	Nojahr
December	Dikahbr
Zondag	Woskrehstzennie
Maandag	Penedehlnik
Dingsdag	Wtahrnik
Woensdag	Stzeredah
Donderdag	Tschetwertohk
Vrijdag	Pahnitza
Zaturdag	Stzoebbatta



{==12==} {>>pagina-aanduiding<<}


Nieuwjaar	Nohwengod
de Vasten	Post
Sakramentsdag	Welihkie tschetwertohk
witte Vrijdag	Strastnaja pahtnitza
Paaschen	Pastzcha, sizweth loewas krestzehnnie
hemelvaartsdag	Wasnoestzeme
Palm Zondag	Werbnoewas krestzennie
Pinkster	Schehstwie swaetohwa doehcha
de Oogst	Schahtwa
Kersmis	roshdestwah christohwa



4. Kleeding en verschooning.


Een Halsdoek.	Gahlstoehk, ook halstoek en Kostzinka
Een paar handschoenen	Pertschatki
Een Hemd.	Roebaschka ook Sorohtschka
Een paar Kousen	Schtani, Nishnee plahtie, is podnihtza
Een hoed	Sehliapa
Een rok	Kaftan
Een mantel	Plaschtsch
Een neusdoek	Platoek
Een paar schoenen	Baschmaki
Een paar sporen	Schposi
Een paar laarzen	Sapogi



{==13==} {>>pagina-aanduiding<<}


Een paar slopkousen	Tschoelki
Een overrok	Stzertoek
Eene Waschvrouw	Pratschka
Linnengoed	Biaelje
Een Vest, Kamizool	Kamsohl
Een Kleed	Plahttie
Een muts	Schoehpka
De wasch	Belioh
De knopen	Poehgowittzi
de knoopsgaten	Paehtli
de boezelaar, Schort	Perednik
de naald	Boeloehska
Lijnwaad	Cholstihna
een snoer	Schnoerok
een nachtmuts	Kalpahk
Een Pruik	Parihk
de halskraag	Worotnihk
de vrouwen halsdoek	Foefaika
Zijde kousen	Scholkowie tscoelhki
Gaarn Kousen	Nihtennie tschoelki
kousebanden	Podwaehski
Sokken	Karpetki
Gespen	Praehshki
knie-gespen	Schlifnika praehshki
de opslag	Obschlagah
de Rabatten	Lahtzkani
de Zak	Kormaan
hemdsknopen	Sahponki
Een Kleerschuijer	Schtschotka
Oorringen	Stzergi
Een Speld	Boetafka



{==14==} {>>pagina-aanduiding<<}


Een Naald	Sgolka
de Vingerhoed	Napersto
Zijde	Scholk
Ruwe Zijde	Stziretz



5. Van de Kleuren.


De Kleur	Tzwethi
Scharlakenrood	Ahlii
Wit	Baehlii
Violet	Fiolchitowil
Licht blaauw	Goloebii
Donker blaauw	Stzinii
Bruin	Gwosditschnii
Rood	Kraestznii
Groen	selonii
Geel	shollii
Zwavelgeel	stzerosholtii
Zwart	Tschohrnii
Lila kleur	Lilohwoi
Orange kleur	Pomerahntzowii tzwehi
Rozenkleur	Rosawohwg tzwehta
Stroo-kleurig	stzolohmmennii



6. Krijgswoorden en Benamingen.


Generaal	Generahl



{==15==} {>>pagina-aanduiding<<}


Overste	Polkownik
Eerste Lieutenant	Padpolkownik
Lieutenant	Poroetschik
Vaandrik	Prahporschitschik
een dragonder	Dragoehn
soldaat	stzoldat
gemeen soldaat	Roedowohi
Regement	Polk
Artillerist	Poeschker
Grenadier	Granadehr
Compagnie	Rota
Kanon	Paeschka, oroehdie
Een Veldstuk	Polkowahja poeschka
een Mortier	Morthira
Geweer	Ruschie, moeschket
de Degen	schpaga
het gevest	Iefestz
de Cavallerie	Koanitza, kawallehria
de Infanterie	Pochohla
Ligte Cavallerie	Lotgkaja kohnnitza
een Ruiter	Reitahr
een Musketier	Moeschketehr
een Fuselier	Foesclehr
een konstapel	Poeschkahr
een Pijper	Fleischtschik
een Trommelslager	Barabahnschtschik
een Armee	Ahrmia
Troepen	Wohistzke
een Leger	Lahger, stann
de Marsch	Pachohd
de Fahne	snahmae



{==16==} {>>pagina-aanduiding<<}


de Sjerp, bandelier	scharf
de Lans	Kopiel
schroot	Drob
kruid	Pahrock
de kling	Plinohk
de Scheede	Nohshni
de Rug	Ohboech
een Pijl	Plohstzkost
een dolk	Kinshall
een kanonskogel	Jaedroh
een Bom	Bohmba
de haan	stzabahtschka
de Laadstok	schohmpol
de kruidhoorn	Paroehowohi roshok
een kogeltrekker	Poeschohwnik
een slinger	Prahschtscha
de Wapens	Oroehshic
een Loop	stwol
de poort van een musket	Koerohk
de vuursteen	Kremehn
de stamper, aanzetter	Pribohinik
de Lontstok	pahlnik
de Lont	Filtihl
het kuras	Dahtoe
de lompen	Femlahk
een kruidwagen	porochowohi jascht schik
een bagagie wagen	Toehra
een tent	palehtka
een ronde tent	Schatohr
een schipbrug	shiwoi most



{==17==} {>>pagina-aanduiding<<}


de slag-orde	strohi boewohi paraehdok
de Linie	scherohnga
de vleugel	Kruloh
het eerste gelid	Froent, pehr waja sherohnga
de Reij	Raehd
het gevegt, de slag	stzrashehnie
het slagveld	pohle strashehnia
de hinderlaag	sastzada
een detachement	Otraed
het geleide, geleiding	Kanwohi
een krijgslist	Wohennaja chetrost
eene overvalling	Netschahenneo napadehnie
het alarm	Trewohga
de overwinning	pobaehda
de nederlaag	pobienie, porashenie
de beloning	shohlowanie
het losgeld	Wihkoep
het winterkwartier	sihmniae kwarthiri
de monstering	stzmohtr
de hoofdwacht	Gauptwachta
de schildwacht	Tschastzwohi
Uithongeren	Gohlodom moriht
de aftocht	Bitish sarih wewehtscheroe
de aftocht blazen	Wehtschernoe joe stzaroebiht
de revelje slaan	Oohtrennoejoe sahroebiht



{==18==} {>>pagina-aanduiding<<}


Een stad beschieten	strelaht is poehshok pogohrodoe
Kamperen	Lahgerom stoat
Kapituleren	peregowohri osdatsche mehsta dellat
de toevoer afsnijden	prestz tsch podwohs
het ontwapenen	Roeshio obobrat
afstijgen	stzlestzt stzloschadi
te paard stijgen	Na lohschad sodihtstza
Stormloopen	schtoermowaht, prisloep dellat
Stormderhand innemen	pristoepom wsaet
het Geschut vernagelen	poehschkoe sagwosdiht
halt maken	Octanowehtsza
halt	stztoi
een mijn	padkohp
een mijn springen	podorwaht padkohp
Versterken	Oekreplaht
Werven	Nabiraht stzoldat
slag leveren	Dat bohi
Inkwartieren	stztawit na kwarti
Marcheren	Marschirowaht
Plunderen	rasgrahbit
op de Wacht trekken	Ihtti na karaoel
Alarm slaan	Abodrihtstza
Aftrekken	Otbohi szpohla trabet
de Vesting	Krapost
een Slot	sahmok
Schietgaten	Boaenitzi
de bresse, Stormgat	prolom, bresch



{==19==} {>>pagina-aanduiding<<}


bresse Schieten	poehschetschojoe
bresse Schieten	stztrelbohjn dehllat
bresse Schieten	wstzteneh prolom
een Paard	Loschad
een Zadel	stzedloh
Voorspan	powad
het Paard beslaan	podkow ad Loschad
het Hoefijzer	podkowa
een Halster	Nedaoesdok
Borstriem	Nagroednick
het Rad	Kolastzo
de raden smeeren	smasat kolastze
de Zweep	Knoest
de Stal	Kartoeschna
Haver	Awoehstz
Teer	salo
Hooi	seno
Stroo	soloma
de Roskam	skrebnitza
de Stijgbeugel	stremena
de Toom	Oesda
de Kinketting	ste Tzepotschka
een moe paard	Oestahlla Loschad
een bruin Paard	Gnedahja
een koppig Paard	stahja Loschad
een mak Paard	smihrnaja Loschad





{==20==} {>>pagina-aanduiding<<}

7. Muzijk-Instrumenten.


Muzijk	Moehsika
de Viool	stzkrhipta
het Klavier	Klawikohrdi
een Harp	Ahrfa
een Fluit	Flheita
een Trompet	Troebah
Pauken	Litahwri
de Doedelzak	Woloehnka
de Strijkstok	stzmoetschohk
De Kam op de Viool	podstztahwka, koboelkha
op het Klavier speelen	Igraht na klawikohrdach
de Klavieren	Klahwischi
de snaar	sttroenah



8. Kleine Zamenspraken.


Goeden dag	sdrahwstwoeite, sdrawhstwoei
Goeden dag Mijnheer	sdradwstwoei stzoedahr
Goeden dag Mevrouw	sdrahwstwoei stzoedarina



{==21==} {>>pagina-aanduiding<<}


Hoe vaart gij?	Wstze li wi wdohbromsdarohwii?
God dank! redelijk	stzlahwa bohgoe! Israchdno
Waar komt gij vandaan?	Atkoehda wi ideohte?
Ik kom van huis	Ja idoeh ihs domoeh
Waar gaat gij heen?	Koedah wi idiohte?
Wanneer zult gij ons komen bezoeken?	Kagdah wi nastz postsetihte?
In deze dagen	Na aehtich dnjaheh
Ik groet u tot wederziens	praschtschahile, prascht schahi do stzwidahnie
waarheen zo haastig?	Koedah wi tek stzkoroidiohte?
gij loopt spoedig	wi ohtschen stzpeschihte
Ik heb veel te doen.	Oe, menjaeh jehst mnohgodehl
Laat ons naar de herberg gaan, daar is het warm.	paidiohm wkloeb, tamdawohlno teploh
ik dank u zeer, ik heb heden geen tijd.	pokohrno blegadaroeh, mne stzewoh dnae nieht wrehmeni
hoe is het met den tijd?	Kotohrii tschastz?
het is niet ver van zeven	skohro oedahrit stzem
het is acht uur	Wohstzem tschaszohw
laat ons in den tuin gaan	poidiohm-tew’ stzad
Als het u belieft	Jestli wam oegshdna
Ach, wat is het warm	Ach! kak shahrko
Ik zweet sterk	Ja wes w’ pohtoe



{==22==} {>>pagina-aanduiding<<}


het onweert reeds van verre	Oehshe mohlniae stzwerkahet igrom grimit is daloeka
Waar wilt gij heen reizen?	Koedah wi jehdite?
Ik reis naar Hamburg	Jajehdoew’ Gahmboerch
wanneer gaat gij reizen?	Kagdah wi pajehdite?
Zoo aanstonds	stzei tschastz
Dan wensch ik u een gelukkige reis.	Itak shelahjoe wam bla gopaloehtschna gopoetik
geef mij brandewijn	Daij mna wotki
geef mij brood	Daijt mna Chleb
Ik wil naar bed gaan	Ja poidoe spat
Geef mij licht	podaij mna swaetschoe
Ik wensch u goede nacht	Ja wam schela joe spokoinnoij Notschi
Snuit het licht uit!	pogastzi schwaetschoe
gij moet betalen	Jebe saplatit dolschne
wat kost het Pond?	Tschto stoit foent?
dat is duur	Eto dorogo
Zeer gaarne	Iswolte
gij hebt gelijk	Wascha prawda
Belieft het u te gaan wandelen?	Oegrodro li goeliat
ga slapen!	padi spat
Kom hier!	padi sjoedin
Roep den bedienden	Klik mna Tschelowaeka
wat belieft u?	Tschto wam oegodno
Mijn vriend, wijst ons den weg	Droeg moi pokaschi nam Darogoe
Gaat gij regt uit?	paditte priamo



{==23==} {>>pagina-aanduiding<<}


Ik ga met u	Ja poidoe swami
Zijt zoo goed	poschaloeite
Verstaat gij Russisch?	Rasoemehete li wi pa rochstzki?
zeer weinig	Ohtscheu mahla
waar is de waard?	Gda Chosjain?
hij is niet te huis	Eys doma naet
wat gelieft u te eten?	Tschto wam oegodno koeschat?
Wilt gij met mij eten?	Ne is wolise li so mnojo otobadat?
Laat de tafel spoedig dekken.	Weli poskoreie nakrivat na stoll
De tafel is reeds gedekt	stol oesche nakoit
Laat het eten opdoen	weli podawat koeschanie
Wilt gij Koffij drinken na het eten?	Boedete li paslae obada koeschat kofe?
ga eeten	Padi koeschat
zet u als ’t u belieft	Sadites poschaluite
waar komt gij vandaan?	Otkoeda ivi idete?
wat belieft u te drinken?	Tschto wam oegodno pit?
veeg de tafel af	Witschisti stoll
wilt gij drinken?	Is wolte li wi pit?
witte of roode wijn?	Belago ili krasnago win
Ik drink liever roode	Ja latsche pioe krasmoe
dadelijk	Sei tschassa
verstaat gij mij?	Rosimi pomietz ky?
het is warm	Jebleh
het is koud	Schimno
kom binnen	Potisim waspanni
Ik dank u	Dan jespanni



{==24==} {>>pagina-aanduiding<<}


waar is de Snuiter?	Gda Tschiptzi?
het is daar zeer zeker	Jest konetschno
in het geheel niet	Ni kak wat
waar woont gij?	Goiewaschi dom
is het ver van hier?	Dalekoli jesehtschitoedoe
zeer nabij	Wesma blisko
waar gaat gij zoo haastig naar toe?	Koeda wi tak toropites?
Ik ga naar huis	Ja idoe domoi
waar is de Heer?	Gdae Hospodin
wat is dat?	Tschtoeto? of tzotto jestpannih
geef mij een pijp Tabak	Poschaloeijte Tabakkoe
hoe hiet dat?	Kak nasiwaetsa eto?
waar zal ik naartoe gaan?	Koeda mnae jiti?
hier naar toe	Siöeda
waar naar toe	Toeda



9. Klein Hollandsch en Russisch Woordenboekje.


A


Aarde, Semlaeh

Adelaar, oriol

Afuitmaker, Roeshehnu mahster

Arabier, Arahwlaehnin

Asch, Ostz

Avondmaal ewcharistia




B


Barbier, Tzeroehlnik of Bradobrehi

Bakker, Ghlehbnik

Beek, Roetscheli

Beer, Medwehd

Bediende, Sloehgah of Lahkei

Begravenis, Pogrebahnie




{==25==} {>>pagina-aanduiding<<}


Been, Nogah

Berg, Gorah

Bed, Besthelae

Betalen, Platihl

Beurs, Birsha

Blik, Shestz

Bliksem, Moehlniae

Bloem, Tzehtohk

Bloed, Krof

Boer, Krestijaehnin

Bodem, Tscherdahk

Boos zijn, Stoy

Booswicht, Slodehi

Borst, Groehd

Borstel, Sohtschotka

Boekdrukker, Tipograehfschtschik of Teredohr schetschik

Boekverkooper, Knigoprodahwer

Bontwerker, Sornaehl of Schoehbnik

Breidel, Pohwodi

Brengen, prinossiht

Broeder, Brahtetz of Brat

Bron, Kolohdes

Brug, Most

Buikloop, Panohstz

Bij, Oe

Bijbel, Bihblia




C


Catholiek, Catolik

Christen, Christianin




D


Daar, Wot

Dak, krohwlae

Dal, Dohlina

Dadelijk, Totschahs

Deen, (een) Datschahnin

Deur, Worothoe

Die, stzei, deze, stziae dit, stzie

Dik, Tohlstoi of Tolst

Disselboom, Dupschlo

Dochter, Dotsch

Doop, Kreschtschehnia

Dooiweer, Ohttoepel

Donder, Gromm

Droog, stzoechoy

Duitscher, Nehmetz

Duivel, Dihawol




E


Edelman, Dworenihoe

Eed, Prissjaega

Eer, Tschest

Ellende, Bieda

Emmer, Wedroh

En, J

Engelschman, Anglitschahnin




{==26==} {>>pagina-aanduiding<<}


Evangelie, Jewangelie




F


Franschman, Frantzoes




G


Gaffel, Vork, Wilitsche

Garst, Ietschmahn

’t Gebeente, kost

Genoeg, Dowohlno

Gereformeerde, Reformath

Gevangenis, Tioermah

Geven, dat

’t Gezicht, Litzoh

Gezondheid, Idarowje

Glas, Stekloh

God, Hospod

God, Bog

Gord-riem, Podjwoehgi

Gras, Trawah

Grendel, Sadwishka

Griek (een) Grehk

Grond, vloer, Poll

Grootvader, Daehdoeschka

Grootmoeder, Daehboeschka

Gij, Wot, ti

Geestelijke, Doechohwniitschelowehk




H


Hagel, Grad

hals, schcha

handen, Rochli

’t hart, stzehrtze

de Haren, Wohlassi

haven, Gahwan of port

haver, Awoehs

hemel, Nehbo

hengst, sherebehtz

hennip, konoplaeh

herberg, kroeg, kabahk

hij, On

hier, sdess

hoef, kopuhto

hoest, kahschol

hofstede, Divor

Hollander, Gollahndetz

honig, Miod

’t Hoofd, Golawah

hoogtijd, stzadba

hooi, stzehno

hospitaal, Gostzpihtal of Bolnihtza

de huid, kohscha

huis, Domm

hond, stzabaka




{==27==} {>>pagina-aanduiding<<}



I


Ja, da

Ik, Ja

Italiaan, Italiahner

Jongeling, Ioenoscha

Jufvrouw, Dehwitza




K


Kam, Grehben

Kamer, Pakobi, Gohrnitza of Wasbe

Kar, Telaegha

Kandelaar, Schandal

Kas, kast, Schkaf

Kat, Kohschka

Keizer, Imperahtor

Keizerin, Imperatrihtza

Kerk, Tzehrkof

Keuken, Powahrnae koehehnae

Kin, Podbarohdok

Kreupel, Kalochka

klijn, Melenkij

Kleermaker, Partnohi

knie, Kalaehna

knaap, Mahltschik

koliek, Kohltka

Koning, karohl

Koningin, karolowa

koole, Oegol

koornschuur, Chlehbnoisarahi

’t koud vuur, Antoh nonagohn

koorts, Licnarahdka

krets, Tschessohtka

kroeg, herberg, Traktihr of Posslojaclii dwor

kribbe, Jaessli

kruik, krorhshka

kussen, zoenen, Tzaelowaht

een aardig meisje kussen, Charohschjoc dehwoeschkoe tzaclo waht




L


Ladder, Lehstnitza

Lendenen, Laedwehi

Lepel, Lefka

Lezen, tsahitaht

Lidteeken, Rochbetz

Lieden, volk, Jioedey

Liefde, Jjoebwy

Lijf, ligchaam, Tehlo

Lood, Swinichtz

Loop, (roode) krowahwii panohs

Lucht, Wehsdoech




{==28==} {>>pagina-aanduiding<<}


Luis, Wosch

Lutheraan, Loeteranin




M


Maagd, Sloeshahnka

Maag, Sheloehdok

Mademoiselle, Waspannah

Mager, Stzoechoschtschahf

Man, Moehsh

Manspersoon, Moeschtschihna

Marktplaats, Plohsohtschad

Matras, Tiöefachk

Mazelen, kor

Medicijn innemen, Prinimaht lekahrstwo

Mensch, Tschelowehk

de mijne, Mohi; de hare majah

het mijne, Moeh

Moeder, Mahtioeschka of Mat

Moeras, Loehsha

Mond, Rot

Muis, Musch




N


Neef, Dwojoerohdnoibrat

Neus, Noss

Nevel, Toemahnoe




O


Onmagt, Ohbmarok

Onder, Pod

Onze, nasch

Oog, Glas

de Oogen, Glasamm

Oom, Duehda

Op, na

Opwaarts, na werch

Oor, Oehcha

de Ooren, Oehschi

Orgel, Orgahni

Oudheid, Staroeschka

Ouderdom, starihk

Oven, Pehtsch

Overwinning, Pobaehda

Overal, wesdeh




P


Pakwagen, Foehra

Peet, krehstnik

Pest, Tschoemah of Morowahja of Jaehsma

Pis, Motschah

Ploegen, Pachath

de Pokken, Ohsspa




{==29==} {>>pagina-aanduiding<<}


een Pool, Polahk

Poort, warohtta

Predikant, Propowaednik

Predikatie, Prohpowaed

Preêkstoel, katoehdra




R


Regts, na prave

Regt uit, priamo

Regen, Dohshd

Rigter, snidihae

Rogge, Rosh

Roos, rohsa

Roskam, sehrebnihtza

Ruin, Mehrin

Rug, spinah

Rusch, Rossiaehnin

Rot, kruhssa




S


Schimmel, Behtaga loeschad

Schoon, prigohsh of Charohsch

Schouders, pletschah

Schoenmaker, sapohshnik

Schrijnwerker, stolaer

Slotenmaker, sleshsar

Slot, smokh

Sleutel, kloethsch

Sleede, Ysslee, sahni

Smit, koesnehtz

Snuifdoos, tabakehrka

Spanjaard, Jstzpahnetz

Spiegel, sehrkalo

Spinnewiel, praedihlnoekolestzch

de Sporen, schpohri

Staart, Chwost

Staart-riem, pahchwi

Stad, Gohrod

Stal, stahl

de Starren, swesdih

Steen, kahmen

Stoel, stoehl

Stok, pahlka

Stoof, kobuchla

Storm, Boehrae

Stroo, solohma

Straat, Ochlitza




T


Tafel, torf

Tand, soehb

Tandpijn, soehbnahjabot

Tante, Toehtka

Tartaar, tatahrin

Tong, Jahsihk




{==30==} {>>pagina-aanduiding<<}


Toom, Oehsda

Tot, ko

Tot mij, komneh

Trap, Lehstnitza

Traagheid, Lienosti

Turk, Toehrok

Turf, torf

Tuin, Sad




U


Uurwerk, tschassih

Uurwerkmaker, Tschasjowschtschihk of Tschassowohi mahster

Uit Is




V


Vaandel, Snahmae

Vader, Bahtiöeschka of Ahtetz

Varen, Jeohati

Vederbosch, Chochohl

Vengster, Oknoh

Verbreken, rwohta

Verkoudheid, Prastoehda

Vet, shihrnii

Vinger, Pahtzi, Pehrsti

Visschen, rihboe lawith

Vlas, Leun

Vleeschhouwer, Mahssnik

Vlieg, Moehscha

Vloo, Blochah

Vloet, rekah

Vloot, shenah

Voet, Nogar

Volk, Nearot

Voor, dlae

Voor mij, dla menjaeh

Voor, pred

Vorst, Maehd

Een Vorst, kniaehs

Vorstin, kniaegihna

Vos, rishaja loschad

Vuiligheid, kal

Vuur, Agohn

Vreemdeling, prisch letz

Vriendschap maken, Goerrah

Vriend, Droeck Agniom

Vrienden, radost of droesey

Vriendin, priaehtelnitza

Vrouw, shenak

Vrouwspersoon, shehnschtschina

Vijand, Nehdroek of Nepriaehtel




{==31==} {>>pagina-aanduiding<<}


Vijver, proed

Voorstad, predmehstie




W


Wal, wal

de Wand, staehna

Waar, Ode

Waarheen, koedah

Waar vandaan, Otkoeh da

water, wada

weduwe, wdowah

weide, Loegh

wereld, sweht, mihr

weegluis, klop

welk, kalehrii

welke, katohraja

’t welk, katoeroe

wind, wehter

wiens, van wien, snati

weinig, skohlko

wol, scherste

wolk, Ohblaco

wond, rahna

woud, Tress

wurm, Tscherf




Y


Ys, Lod

Yzer, shelaehso




Z


Zaal, sahla

Zadelmaker, sedoehllnik

Zadelkleed, Tscheprahk

Zand, pressohk

Zee, Mohre

Zeker, pohdlinno

Zekerlijk, Chwohrii

Zegen, pobaehda

Zij, Anah

Zilver, stzerebroh

Zon, stzin

Zoo, To

Zuster, sesstrihtza of sesstrah

Zwaardveger, schpahshnik

een Zweed, Schwed


    
{==32==} {>>pagina-aanduiding<<}





