
   
        
           
               Woordenboekje om het Engelsch te leeren spreken
               Hoofdzakelijk voor de goede uitspraak
               A.J. Hillebrands
           
             
                
                    Dit bestand biedt, behoudens een aantal hierna te noemen ingrepen, een diplomatische weergave van de tweede druk van Woordenboekje om het Engelsch te leeren spreken van A.J.  Hillebrands uit [1865]. Het jaar van uitgave van de eerste druk is onbekend.
                    Er is gebruik gemaakt van een door Stichting Vrijwilligersnetwerk Nederlandse Taal o.l.v. Nicoline van der Sijs en Hans Beelen aangeleverd bestand.
               
               
                   
                       voorplat: Straat → Staat: ‘School-onderwijzer in de Stad Holland, Staat Michigan’
                       p. 1: Straat → Staat: ‘School-onderwijzer in de Stad Holland, Staat Michigan’
                       p. 19: Coffer → Coffee: ‘Koffij. Coffee. Kof-fie.’
                   
               
           
           
           
               hill064woor02_01
               DBNL-TEI 1
               
                   2020 dbnl / A.J. Hillebrands
               
           
           
               
           
           
               
                   
                   exemplaar Universiteitsbibliotheek Amsterdam, signatuur: Br. P n 3, scan van Google Books
               
               A.J. Hillebrands, Woordenboekje om het Engelsch te leeren spreken. G. Theod. Bom, Amsterdam [1865] (tweede druk)
               
           
       
       
           
               Wijze van coderen: standaard
               
           
       
       
           
               Nederlands
           
       
       
           
               Woordenboekje om het Engelsch te leeren spreken
               Hoofdzakelijk voor de goede uitspraak
               A.J. Hillebrands
               
               
               
                   
                   
                   
               
           
           
           
           
               
           
           
               
               
           
           
           
           
       
       
           
               Woordenboekje om het Engelsch te leeren spreken
               Hoofdzakelijk voor de goede uitspraak
               A.J. Hillebrands
               
               
               
                   
                   
                   
               
           
           
           
           
               
           
           
               
               
           
           
           
           
       
       
           
               2020-06-16
               
                   VB
               
               colofon toegevoegd
           
       
   

Verantwoording 

Dit tekstbestand is gebaseerd op een bestand van de Digitale Bibliotheek voor de Nederlandse Letteren (https://www.dbnl.org)

Bron: A.J. Hillebrands, Woordenboekje om het Engelsch te leeren spreken. G. Theod. Bom, Amsterdam [1865] (tweede druk)
 
Zie: https://www.dbnl.org/tekst/hill064woor02_01/colofon.php

In dit bestand zijn twee typen markeringen opgenomen: paginanummering en illustraties met onderschriften. Deze zijn te onderscheiden van de rest van de tekst door middel van accolades: {==13==} {>>pagina-aanduiding<<} {==Figuur. 1: Onderschrift van de afbeelding.==} {>>afbeelding<<} 





{==voorplat==} {>>pagina-aanduiding<<}

WOORDENBOEKJE
om het
ENGELSCH TE LEEREN SPREKEN;
hoofdzakelijk
VOOR DE GOEDE UITSPRAAK,
door
A.J. HILLEBRANDS,
School-onderwijzer in de Stad Holland, Staat Michigan,
in de Vereenigde Staten van Noord-Amerika.
TWEEDE DRUK.
te amsterdam, bij
G. THEOD. BOM. 
De prijs is …….. f 0,15.
20 Exemplaren op eenmaal besteld. f 2,50. 


{==binnenkant voorplat==} {>>pagina-aanduiding<<}



{==1==} {>>pagina-aanduiding<<}

WOORDENBOEKJE
om het
ENGELSCH TE LEEREN SPREKEN;
hoofdzakelijk
VOOR DE GOEDE UITSPRAAK,
door
A.J. HILLEBRANDS,
School-onderwijzer in de Stad Holland, Staat Michigan,
in de Vereenigde Staten van Noord-Amerika.
TWEEDE DRUK.
te amsterdam, bij
G. THEOD. BOM.


{==2==} {>>pagina-aanduiding<<}





{==3==} {>>pagina-aanduiding<<}

A.


Aalbessen.	Currents	Kur-rents.Op de lettergrepen, welke cursijf gedrukt zijn, moet de klank vallen.
Aalbessenstruik.	Current-bush.	Kur-rent-busj.
Aanbevelen.	To recommend.	Toe rek-kum-mend.
Aandringen.	To insist.	Toe in-sist.
Aangenaam.	Agreeable.	E-grie-ee-bel.
Aangezigt.	Face.	Fees.
Aankleeder.	Dresser.	Dres-sur.
Aankomen.	To arrive.	Toe er-rijv.
Aankomst.	Arrival.	Ar-ri-val.
Aankondiging.	Advertisement.	Ed-ver-tijs-ment.
Aankweeken.	To cultivate.	Toe kul-ti-veet.
Aanleering.	Learning.	Ler-ning.
Aanmelding.	Reporting.	Re-por-ting.
Aanminnelijkheid.	Loveliness.	Lov-lij-nes.
Aanmoedigen.	To excite.	Toe ek-sijt.
Aanneming.	Reception.	Re-zep-sjun.
Aanpakking.	Taking.	Tee-king.
Aanprating.	Persuasion.	Per-su-ee-sjun.
Aanprijzing.	Recommandation.	Re-com-men-dee-sjun.
Aanstranding.	Stranding.	Stran-ding.
Aanteekenboek.	Pocket-book.	Pok-ket-boek.
Aanteekening.	Marking.	Mar-king.
Aantreffing.	Meeting.	Miet-ing.
Aanvallig.	Lovely.	Lov-lie.
Aap.	Monkey.	Man-kie.
Aar.	Ear.	Ier.
Aard.	Nature.	Neet-jur.
Aardappel.	Potatoo.	Poo-tee-toe.
Aardbezie.	Straw-berry.	Stroo-ber-rie.



{==4==} {>>pagina-aanduiding<<}


Aardbol.	Globe.	Gloob.
Abrikoos.	Aprikot.	Ee-pri-kot.
Acht.	Eight.	Eejt.
Achterbeen.	Hindleg.	Hind-leg.
Achterdeur.	Backdoor.	Bek-door.
Achtereinde.	Backpart.	Bek-part.
Achtergevel.	Back-front.	Bek-front.
Achterkamer.	Backroom.	Bek-roem.
Achter.	Behind.	Bie-hind.
Achttien.	Eighteen.	Eej-tien.
Aderlaten.	To bleed.	Toe-blied.
Advent.	Advent.	Ed-vent.
Afhuurder.	Hirer.	Hy-rer.
Afkluwing.	Picking.	Pik-king.
Afknippen.	To pare.	Toe-peer.
Afrekening.	Deduction	De-duk-sjun.
Afschering.	Shaving.	Sjee-ving.
Afschijning.	Shining.	Sjij-ning.
Afschrift.	Copy.	Cop-pie.
Afstand.	Distance.	Dis-tanz.
Aftapping.	Drawing.	Droaw-ing. Oa spreke men iets langer uit, dan de o in bord.
Afwachting.	Waiting for.	Oeweet-ting for.
Akker.	Field.	Field.
Albany. Eene stad in N. Amerika.	Albany.	Al-ba-nie.
Alles.	All.	Oal.
Altaar.	Altar.	Oal-tar.
Alabama. Een der V. Staten van N. Amerika.	Alabama.	A-la-ba-ma.
Amandelen.	Almonds.	Aa-mundz.
Ambachtsman.	Trades-man.	Tree-des-mun.
Amerika.	America.	A-mee-ri-ke.
Anijszaad.	Anise-seed.	A-nijs-sied.
Anker.	Anchor.	En-kor.



{==5==} {>>pagina-aanduiding<<}


Ankertouw.	Cable.	Kee-bel.
Antwoord.	Answer.	Ens-oewer.
Appel.	Apple.	Ep-pel.
Appelboom.	Apple-tree.	Ep-pel-trie.
Appeldrank.	Cider.	Cij-der.
Appelmand.	Apple-basket.	Ep-pel-bas-ket.
Appeltaart.	Apple-pie.	Ep-pel-pij.
April.	April.	Ee-pril.
Arbeid.	Work.	Oework.
Arbeider.	Workman.	Oework-mun.
Arend.	Eagle.	Ie-gel.
Ark.	Ark.	Ark.
Arm. Niet rijk.	Poor.	Poer.
Arm. Een deel van het menschelijk ligchaam.	Arm.	Arm.
Armstoel.	Arm-chair.	Arm-tsjaer Ae spreke men iets langer uit, dan de e in er..
Artsenijkunde.	Physick.	Vie-sik.
Asch.	Asches.	Es-jes.
Avond.	Evening.	Iev-ning.
Avondeten.	Supper.	Sop-per.
Avondschool.	Evening-school.	Iev-ning-skoel.
Azijn.	Vinnigar.	Vin-ni-gar.
Azijnflesch.	Vinnigar-bottle.	Vin-ni-gar-bott-el.



B.


Baard.	Beard.	Bierd.
Bakker.	Baker.	Bee-kur.
Baksteen.	Brik.	Brik.
Bal.	Ball.	Boal.
Balein.	Whale-bone.	Hoeweel-boon.
Bank. Zitbank.	Bench.	Bensj.
Bankgeld.	Bank-money.	Benk-mon-nie.
Barbier.	Barber.	Bar-ber.



{==6==} {>>pagina-aanduiding<<}


Barbierswinkel.	Barber's-shop.	Bar-bers-sjap.
Barnsteen.	Amber.	Am-ber.
Bed.	Bed.	Bed.
Beddedeken.	Blanket.	Blin-ket.
Beddelaken.	Sheet.	Sjiet.
Beddetafel.	Night-table.	Nijt-tee-bel.
Bedgenoot.	Bedfellow.	Bed-fel-ler.
Bedroefdheid.	Sorrow.	Sor-ro.
Been. Meervoud beenderen.	Bone.	Boon.
Been.	Leg.	Leg.
Beer.	Bear.	Beer
Behoeftig.	Indigent.	In-die-szjent.
Behuwdbroeder.	Brother in law.	Bro-ther in loo.
Bekeering.	Conversion.	Kon-ver-sjun.
Beklagen.	To pity.	Toe pit-tie.
Beleefdheid.	Politeness.	Poo-lijt-nes.
Believing.	Pleasing.	Plie-sing.
Beminde.	Sweetheart.	Soewiet-haart.
Beminnelijk.	Lovely.	Lov-lie.
Beminnen.	To love.	Toe lov.
Beminnaar.	Lover.	Lov-er.
Benadeeling.	Hurting.	Hurt-ing.
Benaming.	Nomination.	No-mi-nees-jun.
Beneden.	Below.	Bi-loo.
Beplanting.	Planting.	Plen-ting.
Berg.	Hill.	Hill.
Bergzout	Rock-salt.	Rok-solt.
Berigt.	Advertisement.	Ed-ver-tyz-ment.
Beroemd.	Illustrious.	Il-lus-trie-us.
Beschaafdheid.	Politeness.	Poo-lijt-nes.
Beschaving.	Planing.	Plee-ning.
Bescheidenheid.	Discretion.	Dis-krees-jun.
Beschildering.	Painting.	Pijn-ting.
Beslissen.	To decide.	Toe die-sijd.
Besluit.	Resolution.	Rez-oo-lioe-sjun.
Besturen.	To direct.	Toe di-rekt.



{==7==} {>>pagina-aanduiding<<}


Betasting.	Feeling.	Fie ling.
Beteekenis.	Meaning.	Mien-ing.
Beukenboom.	Beech-tree.	Bietsj-trie.
Bevel.	Last.	Last.
Bevoegdheid.	Ableness.	Ee-bel-nes.
Bevolking.	Peopling.	Pie-pling.
Bevrediging.	Pacification.	Pa-sie-fie-kees-jun.
Bevriezing.	Freesing.	Frie-zing.
Bewaring.	Saving.	See-ving.
Bezem.	Broom.	Broem.
Bezigheid.	Occupation.	Ok-kjoe-pee-sjun.
Bezigtiging.	Inspection.	In-spek-sjun.
Bezig.	Busy.	Biz-zie.
Bezoek.	Visit.	Vis-it.
Bier.	Beer. Ale.	Bier. Eel.
Bierflesch.	Beer-bottle.	Bier-bott-el.
Bijbel.	Bible.	Bieb-el.
Billijk.	Just.	Dzjust.
Bladen.	Leaves.	Lievz.
Bladwijzer.	Index.	In-diks.
Blankheid.	Whiteness.	Hoewijt-nes.
Blazen.	To blow.	Toe bloo.
Bleek.	Pale.	Peel.
Bliksemvuur.	Lightning.	Lijt-ning.
Blindheid.	Blindness.	Blind-nes.
Blijde.	Glad.	Glad.
Bloed.	Blood.	Blod.
Bloeding.	Bleading.	Blieding.
Bloedspuwing.	Spitting of blood.	Spit-ting of blod.
Bodem.	Bottom.	Bott-om.
Bodemloos.	Bottomless.	Bott-om-les.
Boek.	Book.	Boek.
Bloem.	Flower.	Flou-er.
Bloeisel.	Blossom.	Blos-som.
Bloempot.	Flower-pot.	Flou-er-pot.
Boekbinder.	Book-binder.	Boek-binder.



{==8==} {>>pagina-aanduiding<<}


Boekdeel.	Volume.	Vol-lum.
Boekdrukker.	Printer.	Prin-ter.
Boekhandel.	Book-trade.	Boek-treed.
Boekhouder.	Book-keeper.	Boek-kie-per.
Boekverkooper.	Bookseller.	Boek-sel-ler.
Boekweit.	Boekweet.	Bok-hoewiet.
Boer.	Farmer.	Faa-mur.
Boerderij.	Farm.	Faam.
Boerenhuis.	Farmers-house.	Faa-murs-hous.
Boerenvolk.	Country-people.	Con-trie-pie-pel.
Boezelaar.	Apron.	Ee-pron.
Boezem.	Bosom.	Boe-zum.
Boezemvriend.	Bosom-friend.	Boe-zum-frend.
Bontwerk.	Pelt.	Pelt.
Boom.	Tree.	Trie.
Boomwas.	Grafting-wax.	Graf-ting-oeweks.
Boomwol.	Cotton.	Cott-on.
Boonen.	Beans.	Biens.
Boosheid.	Badness.	Bed-nes.
Boot.	Boat.	Boot.
Bord. Tafelbord.	Plate.	Pleet.
Bos.	Bunch.	Bonsj.
Boston. Eene stad in N. Amerika.	Boston.	Bos-ton.
Bosch.	Wood.	Oewoed.
Boter.	Butter.	Bott-er.
Boterboer.	Butterman.	Bott-er-mun.
Boterpot.	Butterpot.	Bott-er-pot.
Bouwhuis.	Barn.	Baan.
Bovendeur.	Upperdoor.	Op-per-door.
Bovenkous.	Upperstocking.	Op-per-stok-king.
Bovenlip.	Upperlip.	Op-per-lip.
Bovenlucht.	Sky.	Skie.
Brand.	Fire.	Fijr.
Brandewijn.	Brandy.	Bren-die.
Brandglas.	Barning-glas.	Bur-ning-glas.
Brandklok.	Fire-bell.	Fijr-bel.



{==9==} {>>pagina-aanduiding<<}


Breijing.	Knitting.	Nit-ting.
Brief.	Letter.	Let-ter.
Brieventasch.	Letter-case.	Let-ter-kees.
Bril.	A pair of spectacles.	E pear of spek-tik-els.
Broeder.	Brother.	Bro-ther.
Broek.	A pair of breeches.	E pear of brits-jes.
Bronwater.	Welwater.	Oewel-oewoa-ter.
Brood.	Bread.	Bred.
Broodbakker.	Baker.	Bee-kur.
Broodbord.	Bread-dish.	Bred-disj.
Buffel.	Buffle.	Buf-fel.
Buffalo. Eene stad in N. Amerika.	Buffalo.	Buf-fel-oo
Bruid.	Bride.	Brijd.
Bruidegom.	Bridegroom.	Brijd-groem.
Bruiloft.	Wedding-feast.	Oewedd-ing-fiest.
Buik.	Belly.	Bel-lie.
Buitenlieden.	Country-men.	Koun-trie-men.
Buur.	Neighbour.	Nee-bor.
Buurt.	Neighbourhood.	Nee-bor-hoed.
Baltimore.	Baltimore.	Bal-tie-moor.



C.


Caroline. Een der V.S. van N.A.	Caroline.	Ka-ro-lij-ne.
Chocolade.	Chocolade.	Tsjok-oo-let.
Christus.	Christ.	Krijst.
Cigaar.	Cigare.	Sie-gaar.
Cirkel.	Cirkel.	Sir-kel.
Citroenen.	Lemons.	Lem-munz.
Citroenboom.	Lemon-tree.	Lem-mun-trie.
Citroensap.	Lemonade.	Lem-mun-need.
Connecticut. Een der Vereenigde Staten van N. Amerika.	Connecticut.	Kon-net-tie-kut.





{==10==} {>>pagina-aanduiding<<}

D.


Dader.	Doer.	Doe-er.
Dag.	Day.	Dee.
Dagblad.	Newspaper.	Njoes-pee-pur.
Daglicht.	Day-light.	Dee-lijt.
Dak.	Roof.	Roef.
Damp.	Steam.	Stiem.
Dampkring.	Atmosphere.	Et-mos-feer.
Dankbaar.	Thankful.	Thank-foel.
Dankbaarheid.	Gratitude.	Gret-ie-tioed.
Dansen.	To dance.	Toe denz.
Dapper.	Valiant.	Vel-junt.
Deel. Gedeelte.	Part.	Part.
Deken.	Blanket.	Blen-ket.
Delaware. Een der Ver. St. van N. Amerika.	Delaware.	De-la-wa-re.
Dertien.	Thirteen.	Thir-tin.
Dertig.	Thirty.	Ther-tie.
Deur.	Door.	Door.
Dewijl.	Because.	Bie-koas.
Dienst.	Office.	Af-fis.
Dief.	Thief.	Thief.
Dienstknecht.	Servant.	Ser-vent.
Diep.	Deep.	Diep.
Dier.	Animal.	En-ni-mal.
Dik.	Thick.	Thik.
Dingsdag.	Tuesday.	Tuus-dee.
Doch.	But.	Bot.
Donderdag.	Thursday.	Thurs-dee.
Donker.	Dark.	Doak.
Doodbed.	Deathbed.	Deth-bed.
Dooden.	To kill.	Toe kiel.
Doof.	Deaf.	Dief.
Doorscheuren.	To tear.	Toe tier.
Doos.	Box.	Baks.



{==11==} {>>pagina-aanduiding<<}


Dorstig.	Dry.	Drij.
Doozenmaker.	Box-maker.	Baks-mee-kur.
Dozijn.	Dozen.	Doz-en.
Drank.	Drink.	Drink.
Drie.	Three.	Thrie.
Drinkbeker.	Cap.	Kop.
Drinkglas.	Drinking-glass.	Drink-in-glas.
Droefheid.	Sorrow.	Sor-roo.
Droogte.	Dryness.	Drie-nis.
Droom.	Dream.	Driem.
Droppel.	Drop.	Drap
Drukker.	Printer.	Printer
Duister.	Dark.	Doak.
Duivel.	Devil.	Div-il.
Duizend.	Thousand.	Thou-send.
Duur.	Dear.	Dier.



E.


Echtelieden.	Married-people.	Mar-rid-pie-pel.
Echtgenoot.	Husband.	Hos-bend.
Echtgenoote.	Wife.	Oewijf.
Edel.	Excellent.	Ek-se-lent.
Eden.	Eden.	Ie-den.
Eekhoorn.	Squirrel.	Skwir-rel.
Een.	One.	Wan.
Eend.	Duck.	Dok.
Eendenei.	Duck-egg.	Dok-eg.
Eer.	Honour.	An-ner.
Eerlijk.	Fairly.	Feer-lie.
Eerlijk.	Honest.	An-nest.
Eerst.	First.	Furst.
Eet.	To eat.	Toe iet.
Eetkamer.	Buttry.	Bott-rie.
Eetlust.	Appetite.	Ep-pe-tijt.
Eettafel.	Dining-table.	Din-ning-tee-bel.
Ei.	Egg.	Eg.



{==12==} {>>pagina-aanduiding<<}


Eigenaardig.	Proper.	Prop-ur.
Eigendom.	Property.	Prop-ur-tie.
Eigenliefde.	Selflove.	Zelf-lov.
Eik.	Oak.	Ook.
Eikenboom.	Oak-tree.	Ook-trie.
Eikenhout.	Oak-wood.	Ook-oewoed.
Eikenloof.	Oak-leaves.	Ook-lievz.
Eikentak.	Oak-branch.	Ook-brensj.
Eiland.	Isle.	IJl.
Eiland.	Island.	IJ-lend.
El.	Yard.	Jard.
Elf.	Elven.	Ellev-en.
Elleboog.	Elbow.	El-boo.
Emmer.	Pail.	Peel.
Engel.	Angel.	En-dzjel.
Ent.	Graft.	Graft.
Enter.	Grafter.	Graft-ur.
Enting.	Grafting.	Graft-ing.
Erie. Kanaal in N. Amerika.	Erie.	E-rie.



F.


Familie.	Family.	Fem-ie-lie.
Feest.	Feast.	Fiest.
Feestdag.	Holi-day.	Hoo-lie-dee.
Fijn.	Fine.	Fijn.
Fluweel.	Velvet.	Vel-vit.
Foei.	Fy.	Fij.
Fondament.	Foundation.	Foun-dee-zjun.
Fout.	Fault.	Foalt.
Florida. Een der Vereen. Staten van N. Amerika.	Florida.	Flo-rie-dee.
Fraai.	Fine.	Fijn.
Frambozen.	Raspberries.	Res-ber-ies.
Frankrijk.	France.	Frenz.





{==13==} {>>pagina-aanduiding<<}

G.


Gaan.	To go.	Toe goe.
Gaauw.	Quick.	Koewik.
Gaauwdief.	Thief.	Thief.
Gaffel.	Fork.	Fork.
Galnoten.	Gall-nuts.	Goal-nuts.
Gans.	Goose.	Goez.
Ganzen.	Geese.	Giez.
Garen.	Thread.	Thred.
Gebed.	Praying.	Preej-ing.
Gebeente.	Bones.	Boons.
Geboomte.	Trees.	Tries.
Geboren.	Born.	Born.
Gebouw.	Building.	Bild-ing.
Gebraad.	Roast-meat.	Roost-miet.
Gedeelte.	Part.	Part.
Geduld.	Patience.	Pee-sjuns.
Geest.	Spirit.	Spier-it.
Geesel.	Whip.	Oewip.
Geheugen.	Mind.	Mijnd.
Geheugen.	Remembrance.	Ree-men-bruns.
Gehoorzaam.	Obedience.	Oo-bie-die-ens.
Geit.	She goat.	Sjie-goot.
Gelaarsd.	Booted.	Boet-id.
Geld.	Money.	Mon-nie.
Geneesheer.	Physician.	Fie-sisj-un.
Gelegenheid.	Occasion.	Ok-kee-sjun.
Geliefde.	Dear.	Dier.
Gelijk.	Like.	Lijk.
Gelijkenis.	Likeness.	Lijk-nes.
Gelijkheid.	Likeness.	Lyk-nes.
Geloof.	Believe.	Bie-liev.
Gelooven.	To believe.	Toe bie-liev.
Gelukzalig.	Happy.	Hap-pie.
Gemakkelijk.	Easy.	Ie-zie.
Genade.	Grace.	Greez.



{==14==} {>>pagina-aanduiding<<}


Georgia. Een der Vereenigde Staten van N. Ameika.	Georgia.	Dzjor-zie-e.
Gepraat.	Bable.	Babb-el.
Geraas.	Noise.	Nois.
Gerust.	Calm.	Kaam.
Gerust.	Quietly.	Koewie-et-lie.
Geschreeuw.	Crying.	Krij-ing.
Gespin.	Buckless.	Buk-kelz.
Gesprek.	Discourse.	Dis-koers.
Gesprek.	Conversation.	Kon-ver-see-sjun.
Gest.	Yeast. East.	Iest.
Gesternte.	Stars.	Staars.
Getal.	Number.	Nom-ber.
Getij.	Tide.	Tijd.
Gevecht.	Fight.	Fijt.
Gevoel.	Feeling.	Fieling.
Geweld.	Force.	Forz.
Gewigt.	Weight.	Oeweet.
Gezant.	Ambassador.	Em-bas-sa-dor.
Gezond.	Healthy.	Helt-ie.
Gezusters.	Sisters.	Sis-ters.
Gij.	You.	Joe.
Glazen.	Glasses.	Glez-zes.
God.	God.	God.
Goed.	Good. Well.	Goed. Oewel.
Goedertieren.	Merciful.	Mer-zie-foel.
Gom.	Gum.	Gom.
Goud.	Gold.	Goold.
Goudmijn.	Gold-mine.	Goold-mijn.
Gordijnen.	Curtains.	Kar-tinz.
Graftombe.	Tomb.	Toem.
Grendel.	Bolt.	Boolt.
Griffel.	Slate-pencil.	Sleet-pen-sil.
Grillig.	Fantastical.	Fen-tes-ti-cul.
Grooter.	Bigger.	Big-ger.



{==15==} {>>pagina-aanduiding<<}


Grootvader.	Grand-father.	Grand-fa-ther.
Gulden.	Gilder.	Gil-der.
Gunstig.	Favourable.	Fee-vur-ee-bul.
Gunst.	Favour.	Fee-vur.



H.


Haagbes.	Black-berry.	Blek-ber-rie.
Haan.	Cock.	Kok.
Haast.	Soon.	Soen.
Halen.	To fetch.	Toe fetsj.
Hals.	Neck.	Nek.
Half.	Half.	Haaf.
Hamer.	Hammer.	Hem-mer.
Hand.	Hand.	Hend.
Handel.	Trade.	Treed.
Handen.	Hands.	Hendz.
Handig.	Handy.	Hen-die.
Handdoek.	Towel.	Tou-il.
Handmolen.	Handmill.	Hend-mill.
Handschoen.	Gloves.	Glovz.
Hanekam.	Cocks-comb.	Koks-koom.
Hart.	Heart.	Haart.
Haring.	Herring.	Herr-ing.
Hartvriend.	Bosom-friend.	Boe-zum-frend.
Haven.	Port.	Port.
Haver.	Oat.	Oot.
Havermeel.	Oat-meal.	Oot-miel.
Haverstroo.	Oat-straw.	Oot-strow.
Heer.	Sir.	Sur.
Heester.	Bush.	Bosj.
Heiland.	Saviour.	See-vi-or.
Heilig.	Holy.	Hoo-lie.
Hek.	Fence.	Fenz.
Hel.	Hel.	Hel.
Helder.	Clear.	Clear.
Hemel.	Heaven.	Hev-en.



{==16==} {>>pagina-aanduiding<<}


Herberg.	Inn.	Inn.
Hert.	Dear.	Dier.
Heuvel.	Hill.	Hill.
Hier.	Here.	Hier.
Hoed.	Hat.	Het.
Hoek.	Corner.	Korn-er.
Hoepel.	Hoop.	Hoep.
Holland.	Holland.	Hal-lend.
Hond.	Dog.	Dog.
Honderd.	Hundred.	Hon-derd.
Hooi.	Hay.	Hee.
Hooigaffel.	Hay-fork.	Hee-fork.
Hooimaand.	July.	Dzjoe-lie.
Hoog.	High.	Hij.
Hoorder.	Hearer.	Hier-er.
Horologie.	Watch.	Oewatsj.
Horologiesleutel.	Watck-key.	Oewatsj-kie.
Houden.	To keep.	Toe kiep.
Houder.	Keeper.	Kie-per.
Hout.	Wood.	Oewoed.
Houtbijl.	Axe.	Eks.
Houthakker.	Wood-Cutter.	Oewoed-cot-ter.
Huis.	House.	Hous.
Huiswerk.	Housework.	Hous-oework.
Huren.	To hire.	Toe hijr.
Huurhuis.	Hired-house.	Hijr-id-hous.
Huwelijk.	Mariage.	Marr-edsj.



I. J.


Ja.	Yes.	Jis.
Jaar.	Year.	Jier.
Jaargeld.	Pension.	Pen-sjun.
Jaargetij.	Season.	Siez-on.
Jan	John.	Dzjoun.
Jas.	Coat.	Koot.
Jenever.	Gin.	Dzjin.



{==17==} {>>pagina-aanduiding<<}


Jersey. Een der Ver. Staten van N. Amerika.	Jersey.	Dzjur-sij.
Jeugd.	Youth.	Joes.
Jezus.	Jesus.	Dzjie-zos.
IJs.	Ice.	IJs.
IJskelder.	Ice-house.	IJs-hous.
IJzer.	Iron.	IJr-un.
IJzersmid.	Blacksmid.	Blek-smith.
Ik.	I.	IJ.
Illinois. Een der Ver. Staten van N. Amerika.	Illinois.	Il-li-nois.
Indiana. Een der Ver. Staten van N. Amerika.	Indiana.	In-di-ean-e.
Inoogsten.	Reaping.	Riep-ing.
Jong.	Young.	Joung.
Jongen.	Boy.	Boai.
Jonge juffer.	Young lady.	 Joung lee-die.
Inkt.	Inkt.	Inkt.
Iowa. Een der Ver. Staten van N. Amerika.	Jowa.	Y-oo-wee.
Juweelen.	Jewels.	Dzjioe-ils.



K.


Kaars.	Candle.	Ken-del.
Kaarslicht.	Candle-light.	Ken-del-lijt.
Kaarsongel.	Candle-grease.	Ken-del-gries.
Kaarssnuiter.	Candle-snuff.	Ken-del-snof.
Kaarssnuitsel.	Snuff.	Snof.
Kaas.	Cheese.	Tsjies.
Kaasmade.	Cheese-mite.	Tsjies-mijt.
Kaasmaker.	Cheese-maker.	Tsjies- mee-kur.
Kabel.	Cable.	Kee-bel.



{==18==} {>>pagina-aanduiding<<}


Kagchel.	Stove.	Stoof.
Kajuit.	Cabin.	Kab-in.
Kalf.	Calf.	Kaaf.
Kalfsvleesch.	Veal.	Viel.
Kalk.	Lime.	Lijm.
Kalkpot.	Lime-pot.	Lijm-pot.
Kam.	Comb.	Koom.
Kaneel.	Cinnamon.	Sin-ne-mon.
Kandelaar.	Candle-stick.	Ken-del-stik.
Kat.	Cut.	Ket.
Katoen.	Cotton.	Kott-on.
Kapitein.	Captain.	Kap-ten.
Kelder.	Cellar.	Sel-ler.
Kerstijd.	Christmas.	Kris-mes.
Keuken.	Kitchen.	Kits-jun.
Kentucky. Een der Ver. Staten van N. Amerika.	Kentucky.	Ken-tuk-kie.
Kers.	Cherry.	Tsjer-rie.
Ketel.	Kettle.	Kett-el.
Kieken.	Chicken.	Tsjik-kin.
Kiekenpastei.	Chicken-pie.	Tsjik-kin-pij.
Kikvorsch.	Frog.	Frog.
Kind.	Child.	Tsjijld.
Kinderen.	Children.	Tsjil-dern.
Klaver.	Clover.	Klov-ver.
Kleermaker.	Tailor.	Tee-lor.
Klein.	Little.	Lett-il.
Klok.	Clock.	Klok.
Klomp.	Wooden-shoe.	Oewoed-en-sjoe.
Kloppen.	To knock.	Toe nok.
Kluwen.	Clew.	Klioe.
Knie.	Knee.	Nie.
Knollen.	Turneps.	Tur-nips.
Knolland.	Turnep-field.	Tur-nip-field.
Knoopen.	Buttons.	Bott-ons.
Koe.	Cow.	Kouw.



{==19==} {>>pagina-aanduiding<<}


Koek.	Cake.	Keek.
Koemelker.	Cow-milker.	Kouw-mil-ker.
Koffij.	Coffee.	Kof-fie.
Koffijbaal.	Bale of coffee.	Beel of kof-fie.
Koffijpot.	Coffee-pot.	Kof-fie-pot.
Koffijhuis.	Coffee-house.	Kof-fie-hous.
Komen.	To come.	Toe koom.
Kompas.	Compass.	Kom-pes.
Koning.	King.	King.
Koningin.	Queen.	Koeween.
Koningrijk.	Kingdom.	King-dom.
Koolzaad.	Rape-seed.	Reep-sied.
Koopen.	To buy.	Toe bui.
Koper. (rood.)	Copper.	Kop-per.
Koper. (geel.)	Brass.	Bros.
Koren.	Corn.	Korn.
Korenbloem.	Corn-flower.	Korn-flou-er.
Korenland.	Corn-land.	Korn-lend.
Korenmolen.	Corn-mill.	Korn-mill.
Korenschoof.	Sheef of corn.	Sjief of korn.
Korst.	Cruss.	Kros.
Kort.	Short.	Sjort.
Kostschool.	Boarding-school.	Boor-ding-skoel.
Kousen.	Stolkings.	Stok-kings.
Kousebanden.	Garters.	Gaar-turz.
Koud.	Cold.	Koold.
Krijt.	Chalk.	Tsjoak.
Kraambed.	Child-bed.	Tsjild-bed.
Kozijn.	Frame.	Freem.
Kreupel.	Lame.	Leem.
Kruik.	Bottle.	Bott-el.
Kruis.	Cross.	Kros.



L.


Laag.	Low.	Loo.
Laars.	Boot.	Boet.



{==20==} {>>pagina-aanduiding<<}


Laarzenmaker.	Boot-maker.	Boet-mee-kur.
Laat.	Late.	Leet.
Laatst.	Lately.	Leet-lie.
Lach.	Laugh.	Laaf.
Laken.	Cloth.	Kloth.
Lakens.	Sheets.	Sjiets.
Lamp.	Lamp.	Lemp.
Lampolie.	Lamp-oil.	Lemp-oil.
Land.	Land.	Lend.
Landhuis.	Country-house.	Coun-trie-hous.
Landkaart.	Map.	Map.
Lasteraars.	Slanderers.	Slen-dur-urz.
Lediggang.	Idleness.	IJ-del-nes.
Leder.	Leather.	Leth-ur.
Leelijk.	Ugly.	Ug-lie.
Leeraar.	Teacher.	Tiets-jur.
Leeren.	To teach.	Toe tietsj.
Leesboek.	Reading book.	Rie-ding-boek.
Leeuw.	Lion.	Lij-on.
Leggen.	To lay.	Toe lee.
Lei.	Slate.	Sleet.
Leidak.	Slate-roof.	Sleet-roef.
Lente.	Spring.	Spring.
Lepel.	Spoon.	Spoen.
Les.	Lesson.	Les-son.
Lessenaar.	Desk.	Desk.
Letter.	Letter.	Let-tur.
Leugenaar.	Liar.	Lij-ur.
Leven.	Life.	Lijf.
Lever.	Liver.	Lijv-er.
Lezen.	To read.	Toe ried.
Licht.	Light.	Lijt.
Lichtgroen.	Light-green.	Lijt-grien.
Lieden.	People. Folks.	Pie-pel. Foks.
Lied.	Song.	Song.
Lief.	Lover.	Lov-ur.
Liefste.	Sweetheart.	Soewiét-haart.



{==21==} {>>pagina-aanduiding<<}


Ligchaam.	Body.	Bod-die.
Linkerarm.	Left arm.	Left arm.
Linkerbeen.	Left leg.	Left leg.
Linkerhand.	Left hand.	Left hend.
Linkeroog.	Left eye.	Left ij.
Linkerschouder.	Left shoulder.	Left sjoolder.
Liniaal.	Rule.	Roel.
Linnen.	Linen.	Lin-nin.
Linksom.	To the left.	Toe the left.
Luis.	Louse.	Lous.
Luipaard.	Leopard.	Lep-pare.
Luizen.	Lice.	Lijs.
Louisiana. Een der Ver. Staten van N. Amerika.	Louisiana.	Loe-ie-si-a-ne.
Loodlijn.	Perpendicular.	Per-pen-dik-lur.
Looper.	Runner.	Run-ner.
Loopen.	To run.	Toe run.
Leerling.	Scholar.	Skol-lar.



M.


Maag.	Stomach.	Stom-mek.
Maagd.	Girl.	Gurl.
Maaltijd.	Meal.	Miel.
Maan.	Moon.	Moen.
Maand.	Month.	Month.
Maandag.	Monday.	Mon-dee
Maanlicht.	Moon-shine.	Moen-sjijn.
Mager.	Lean.	Lien.
Magt.	Power.	Pou-er.
Magtig.	Powerful.	Pou-er-fol.
Main. Een der Vereenigde Staten van N. A.	Maine.	Maen.
Maker.	Maker.	Mee-kur.
Mand.	Basket.	Bas-ket.



{==22==} {>>pagina-aanduiding<<}


Mandenmaker.	Basket-maker.	Bas-ket-mee-kur.
Manier.	Manner.	Men-ner.
Mantel.	Cloath.	Kloth.
Markt.	Market.	Mar-ket.
Marktdag.	Market-day.	Mar-ket-dee.
Maryland. Een der Vereenigde Staten van N. A.	Maryland.	Mer-ie-lend.
Massachusetts. Een der Ver. Staten van Noord Amerika.	Massachusetts.	Mas-sa-sju-sets.
Matig.	Frugal.	Froe-gal.
Mededingers.	Rivals.	Rij-vuls.
Meel.	Flour.	Flour.
Meel.	Meal.	Miel.
Meelzak.	Meal-bag.	Miel-beg.
Meisje.	Girl.	Gurl.
Mejufvrouw.	Miss.	Mis.
Melk.	Milk.	Milk.
Melkachtig.	Milky.	Mil-kie.
Melkemmer.	Milk-pail.	Milk-peel.
Melker.	Milker.	Mil-ker.
Melkkoe.	Milk-cow.	Milk-kouw.
Metselaar.	Mason.	Mee-son.
Middag.	Noon.	Noen.
Middagmaal.	Diner.	Din-ner.
Minnaar.	Lover.	Lov-er.
Minnebrief.	Love-letter.	Lov-let-ter.
Mississippi. Eene rivier in Noord Amerika.	Mississippi.	Mis-sis-sip-pi.
Moed.	Courage.	Kor-redzj.
Michigan. Een der Ver. Staten van N. Amerika.	Michigan.	Mi-sjie-gen.
Moeder.	Mother.	Mo-ther.



{==23==} {>>pagina-aanduiding<<}


Moei.	Aunt.	Ant.
Moeite.	Trouble.	Trob-bel.
Molen.	Mill.	Mill.
Mol.	Mole.	Mool.
Mond.	Mouth.	Mouth.
Mooi.	Handsome.	Hand-som.
Morgen.	To morrow.	Toe-mor-roo.
Morgeneten.	Breakfast.	Brek-fest.
Morgenzang.	Morning-hymn.	Mor-ning-himn.
Mostaard.	Mustard.	Mos-terd.
Mostaardzaad.	Mustard-seed.	Mos-terd-seed.
Muis.	Mouse.	Mous.
Muizenvanger.	Mouse-catcher.	Mous-ket-sjer.
Muskaat.	Nutmeg.	Nut-meg.
Muts.	Cap.	Kip.
Muur.	Wall.	Oewoal.



N.


Naald.	Needle.	Nie-del.
Naaldenkoker.	Needle-case.	Nie-del-kees.
Naaldenmaker.	Needle-maker.	Nie-del-mee-kur.
Naarstig.	Diligent.	Dil-ie-dzjent.
Naast.	Next.	Nikst.
Naauwgezet.	Conscientious.	Kon-sjie-en-sjus.
Nacht.	Night.	Nijt.
Nachtgewaad.	Night-dress.	Nijt-dres.
Nachtkaars.	Night-candle.	Nijt-ken-dle.
Nachtlamp.	Night-lamp.	Nijt-lemp.
Nachtuil.	Night-owl.	Nijt-oul.
Nachtwerk.	Night-work.	Nijt-oework.
Nader.	Nearer.	Nier-er.
Nagel.	Nail.	Neel.
Nagelsmid.	Nail-smith.	Neel-smith.
Nagras.	After-grass.	Af-ter-gras.
Namaals.	Here-after.	Hier-af-ter.
Namiddag.	Afternoon.	Af-ter-noen.



{==24==} {>>pagina-aanduiding<<}


Natuur.	Nature.	Neet-jur.
Nazien.	To look after.	Toe loek af-ter.
Neef.	Cousin.	Kos-sin.
Neder.	Down.	Doun.
Niemand.	Nobody.	No-bod-die.
Nieuwsgierig.	Curiou.	Kioe-rie-us.
Net.	Neat.	Niet.
Neus.	Nose.	Noos.
New IJork. Eene stad in N. Amerika.	New York.	Njoe-jork.
Nijdig.	Envious.	En-vie-us.
Nommer.	Number.	Nom-ber.
Noord.	North.	North.
Noordoost.	North-east.	North-iest.
Noordwest.	North-west.	North-oewest.
Noten.	Wall-nuts.	Oewoal-nuts.
Nuttig.	Useful.	Jioes-foel.
New Jersey. Een der Ver. Staten van N. Amerika.	New Jersey.	Njoe-dzjur-sie.



O.


Oceaan.	Ocean.	Oo-sjun.
Oefening.	Exercise.	Eks-er-sijs.
Ohio. Een der Ver. Staten van N. Amerika.	Ohio.	O-hy-o.
Olie.	Oil.	Oil.
Olieachtig.	Oily.	Oil-ie.
Olieflesch.	Oil-bottle.	Oil-bott-el.
Oliekoek.	Oil-cake.	Oil-keek.
Oliepot.	Oil-pot.	Oil-pot.
Oliezaad.	Oil-seed.	Oil-sied.
Omdat.	Because.	Bie-koaz.
Onbekend.	Unknow.	On-noo.



{==25==} {>>pagina-aanduiding<<}


Onderbed.	Underbed.	On-der-bed.
Onderhoorigen.	Inferiors.	In-fie-rie-urz.
Onderlip.	Underlip.	On-der-lip.
Ongelakt.	Not sealed.	Not siel-ed.
Ongeloovig.	Unbelieving.	On-be-lie-ving.
Ongereed.	Unready.	On-red-die.
Ongesmolten.	Unmelted.	On-melt-id.
Ongevraagd.	Unasked.	On-esk-id.
Ongewasschen.	Unwashed.	On-oewasj-id.
Ongezift.	Not sefted.	Not-sift-id.
Ongezond.	Unhealthy.	On-hil-thie.
Onrijp.	Unripe.	On-rijp.
Ontbijt.	Breakfast.	Brek-fest.
Ontuchtig.	Immodest.	Im-mod-dest.
Onverzettelijk.	Firm.	Ferm.
Onvolmaakt.	Imperfect.	Im-per-fekt.
Onmenschelijk.	Inhuman.	In-hioe-mun.
Onnuttig.	Useless.	Jioes-les.
Onweg.	Bad road.	Bed rood.
Onzoet.	Not sweet.	Not swiet.
Oog.	Eye.	Ei.
Oogenblik.	Moment.	Mo-ment.
Oogbal.	Eye-ball.	Ei-boal.
Ooijevaar.	Stork.	Stark.
Ooit.	Ever.	Ev-er.
Oor.	Ear.	Ier.
Oorlog.	War.	Oewoar.
Oom.	Uncle.	On-kel.
Opeten.	To eat up.	Toe iet op.
Opjagen.	To drive up.	Toe drijv op.
Oppermagtig.	Peremptory.	Per-em-tur-ie.
Opperpriester.	High-priest.	Hij-priest.
Opzigt.	Direction.	Die-rek-sjun.
Oranjeappels.	Oranges.	Or-rendzj-is.
Ordelijk.	Methodical.	Mie-thod-ie-kul.
Os.	Bull.	Bol.
Ouwel.	Wafer.	Oewee-fur.



{==26==} {>>pagina-aanduiding<<}


Ouweldoosje.	Wafers-box.	Oewee-furs-bax.
Overkleed.	Upper-coat.	Op-per-koot.



P.


Paar.	Pair.	Pear.Ea spreekt men iets langer uit dan de e in het woord vel.
Paard.	Horse.	Hors.
Paardenstaart.	Horse-tail.	Hors-es-teel.
Paaschavond.	Easter-eve.	Ies-ter-iev.
Paaschbrood.	Easter-loaves.	Ies-ter-loovs.
Paauw.	Pea-cock.	Pie-kok.
Paauwin.	Pea-hen.	Pie-hen.
Pan.	Pan.	Pen.
Pannekoeken.	Pan-cakes.	Pen-keeks.
Papier.	Paper.	Pee-pur.
Paschen.	Pass-over.	Pas-ov-ur.
Pastoor.	Priest.	Priest.
Pen.	Pen.	Pen.
Pensylvania. Een der Ver. Staten van N. Amerika.	Pensylvania.	Pen-sil-va-ni-e.
Pennemes.	Pen-knife.	Pen-nijf.
Peper.	Pepper.	Pep-pur.
Peperboom.	Pepper-tree.	Pep-pur-trie.
Peren.	Pears.	Peerz.
Perzik.	Peach.	Pietsj.
Pet.	Cap.	Kep.
Pijn.	Pine.	Pijn.
Pijnappel.	Pine-apple.	Pijn-ep-pel.
Pijp.	Pipe.	Pijp.
Poeder.	Powder.	Pou-dur.
Pomp.	Pomp.	Pomp.
Pond.	Pound.	Pound.
Post.	Post.	Poost.



{==27==} {>>pagina-aanduiding<<}


Postkantoor.	Post-office.	Poost-af-fis.
Postpapier.	Post-paper.	Poost-pee-pur.
Potlood.	Pencil.	Pens-il.
Praat.	Talk.	Toak.
Prater.	Talker.	Toa-kur.
Profeet.	Prophet.	Praf-fet.
Pruimen.	Plums.	Ploms.
Psalm.	Psalm.	Saam.
Pudding.	Pudding.	Pod-ding.
Put.	Well.	Oewell.



R.


Raadsel.	Riddle.	Rid-del.
Raam.	Frame.	Freem.
Rad. (Wagenrad.)	Wheel.	Hoewiel.
Ram.	Ram.	Rem.
Rat.	Rat.	Ret.
Rattenvanger.	Rat-catcher.	Ret-ket-cher.
Razijnen.	Raisins.	Ries-ins.
Redelijk.	Reasonable.	Rie-zen-ee-bel.
Redenen.	Reasons.	Rie-zens.
Regen.	Rain.	Reen.
Regenboog.	Rain-bow.	Reen-boo.
Regt.	Right.	Rijt.
Regterhand.	Right-hand.	Rijt-hend.
Regtdag.	Court-day.	Koort-dee.
Regtvaardig.	Equitable.	Ek-kioewie-te-bel.
Reis.	Voyage.	Voie-idzj.
Reistuig.	Baggage.	Beg-gidzj.
Rein.	Clean.	Klien.
Reukwater.	Smelling-water.	Smel-ling-oewoa-ter.
Rijk.	Rich.	Ritsj.
Rijkdommen.	Riches.	Ritsj-is.
Riem.	Strop.	Strap.
Rijst.	Rice.	Rijz.
Rijstebrood.	Rice-bread.	Rijz-bred.



{==28==} {>>pagina-aanduiding<<}


Rijstnat.	Rice-water.	Rijz-oewoa-ter.
Rijtuig.	Carriage.	Kar-ridzj.
Rivier.	River.	Riv-er.
Rogge.	Rie.	Rij.
Roggenbrood.	Rie-bread.	Rij-bred.
Rood.	Red.	Red.
Rooken.	To smoke.	Toe smook.
Rookvleesch.	Smoked-beef.	Smook-id-bief.
Room.	Cream.	Kriem.
Roos.	Rose.	Roos.
Rozeblad.	Rose-leaf.	Roos-lief.
Rozestruik.	Rose-bush.	Roos-bosj.
Rug.	Back.	Bek.
Ruggegraad.	Back-bone.	Bek-boon.



S.


Schaaf.	Plane.	Pleen.
Schaafbank.	Bench.	Bensj.
Schaamte.	Shame.	Sjeem.
Schaap.	Sheep.	Sjiep.
Schaats.	Scate.	Skeet.
Schaatsenrijder.	Scater.	Skeet-ur.
Schapenmelk.	Sheep-milk.	Sjiep-melk.
Schapenongel.	Sheep 's grease.	Sjieps-gries.
Schapenvleesch.	Mutton.	Mott-en.
Scherp.	Sharp.	Sjarp.
Scheuren.	To tear.	Toe tier.
Schel.	Bell.	Bell.
Schip.	Vessel.	Ves-il.
Schip.	Ship.	Sjip.
School.	School.	Skoel.
Schoolboek.	School-book.	Skoel-boek.
Schoolgeld.	School-money.	Skoel-mon-nie.
Schooljongen.	School-boy.	Skoel-boai.
Schoolkind.	Scholar.	Skol-lar.
Schouder.	Shoulder.	Sjool-der.



{==29==} {>>pagina-aanduiding<<}


Schrander.	Judicious.	Dzjioe-disj-us.
Schrift.	Writing.	Rij-ting.
Schrijfboek.	Writing-book.	Rij-ting-boek.
Schrijflei.	Writing-slate.	Rij-ting-sleet.
Schrijver.	Writer.	Rij-ter.
Schrobben.	To scrub.	Toe skrop.
Schuit.	Boat.	Boot.
Slager.	Butcher.	Boet-sjur.
Sleutel.	Key.	Kie.
Slapen.	To sleep.	Toe slip.
Sneeuw.	Snow.	Snoo.
Snijden.	To cut.	Toe kot.
Snoeijen.	To lop.	Toe lop.
Snoeijer.	Lopper.	Lopp-ur.
Snuif.	Snuff.	Snof.
Snuifdoos.	Snuff-box.	Snof-baks.
Snuifpot.	Snuff-pot.	Snof-pot.
South-Caroline. Een der Ver. Staten van N. Amerika.	South-Caroline.	South-Ca-ro-ly-ne.
Sparen.	To spare.	Toe speer.
Spek.	Pork.	Pork.
Speld.	Pin.	Pin.
Speldenmaker.	Pin-maker.	Pin-mee-kur.
Speldenkoker.	Pin-case.	Pin-kees.
Spiegel.	Lookinglass.	Loek-ing-glas.
Spoedig.	Quick.	Koewik.
Staal.	Steel.	Stiel.
Staalachtig	Like steel.	Lijk stiel.
Staart.	Tail.	Teel.
Stad.	City.	Sit-tie.
Stad.	Town.	Toun.
Stadsschool.	Town-school.	Toun-skoel.
Stal.	Stable.	Steeb-el.
Standbeeld.	Statue.	Stet-tsjoe.
Steen.	Stone.	Stoon.



{==30==} {>>pagina-aanduiding<<}


Steenrots.	Rock.	Rok.
Stem.	Voice.	Vois.
Sterven.	To die.	Toe dij.
Sterfelijk.	Mortal.	Mor-tul.
Sterk.	Vigorous.	Vig-ur-us.
Stiefmoeder.	Step-mother.	Step-mo-ther.
Stipt.	Punctual.	Punc-tsjoe-ul.
Stoelen.	Chairs.	Tsjearz.
Stopverf.	Putty.	Pot-tie.
Stuk.	Piece.	Pies.
Straat.	Street.	Striet.
Studeeren.	To study.	Toe stu-die.



T.


Tabak.	Tobacco.	To-bek-ko.
Tabaksasch.	Tobacco-ashes.	To-bek-ko-es-jes.
Tabaksblad.	Tobacco-leaf.	To-bek-ko-lief.
Tabaksdoos.	Tobacco-box.	To-bek-ko-baks.
Tabaksland.	Tobacco-field.	To-bek-ko-field.
Tabakspijp.	Tobacco-pipe.	To bek-ko-pijp.
Tabaksplant.	Tobacco-plant.	To-bek-ko-plent.
Tachtig.	Eighty.	Eej-tie.
Tafel.	Table.	Tee-bel.
Tafelbord.	Table-plate.	Tee-bel-pleet.
Tafellaken.	Table-cloth.	Tee-bel-kloth.
Tafelmes.	Table-knife.	Tee-bel-nijf.
Tafeltijd.	Table-time.	Tee-bel-tijm.
Tak.	Branch.	Brensj.
Talloos.	Numberless.	Nom-ber-les.
Tand.	Tooth.	Toeth.
Tandborstel.	Tooth-brush.	Toeth-brosj.
Tarwe.	Wheat.	Hoewiet.
Teer.	Tar.	Tar.
Tennessee. Een der Ver. Staten van N. Amerika.	Tennessee.	Ten-nes-sie.



{==31==} {>>pagina-aanduiding<<}


Thee.	Tea.	Tie.
Theeboom.	Tea-tree.	Tie-trie.
Theehandel.	Tea-trade.	Tie-treed.
Theekoekje.	Tea-cake.	Tie-keek.
Theelepel.	Tea-spoon.	Tie-spoen.
Tijd.	Time.	Tijm.
Timmerman.	Carpenter.	Kar-pen-tier
Toegrendelen.	To bolt.	Toe boolt.
Toeknoopen.	To button.	Toe bott-en.
Toestemming.	Permission.	Per-misj-un.
Toorn.	Anger.	Eng-gor.
Toom.	Briddle.	Bridd-el.
Toren.	Steeple.	Stiep-el.
Touw.	Rope.	Roop.
Traan.	Whale-oil.	Hoeweel-oil.
Treurspel.	Tragedy.	Tred-dzjie-die.
Twee.	Two.	Toe.
Tweedragt.	Dissension.	Dis-sen-zjun.
Twintig.	Twenty.	Twintie.
Trouwen.	To marry.	Toe mer-rie.



U.


Uil.	Owl.	Oul.
Uitgaan.	To go out.	Toe goo out.
Uitglijden.	Slipping out.	 Slip-ping out.
Uitdrukken.	To express.	Toe ex-pres.
Uitkleeding.	Undressing.	On-dres-sing.
Uitkleeden.	To undress.	Toe on-dres.
Uitroep.	Cry.	Krij.
Uitrusten.	To equipe.	Toe ie-koewip.
Uitsnijden.	To cut out.	Toe kot out.
Uur.	Hour.	Our.
Uurglas.	Hour-glass.	Our-glas.
Uurwijzer.	Hour-hand.	Our-hand.
Utica. Eene stad in N. Amerika.	Utica.	Joe-tie-ka.





{==32==} {>>pagina-aanduiding<<}

V.


Vader.	Father.	Fa-ther.
Veder.	Feather.	Feth-ur.
Veertig.	Fourty.	For-tie.
Vel.	Skin.	Skin.
Veld.	Field.	Field.
Venster.	Window.	Win-dou.
Verdacht.	Suspected.	Sus-pekt-id.
Verdrag.	Contract.	Kon-trakt.
Vergeten.	To forget.	Toe for-git.
Vergeven.	To forgive.	Toe for-giv.
Vergiffenis.	Pardon.	Paar-den.
Verheugen.	To decline.	Toe die-klijn.
Verklaren.	To define.	Toe die-fijn.
Verklaring.	Deposition.	Dip-po-zesj-un.
Vermaak.	Pleasure.	Pleszj-ioer.
Vermetel.	Rash.	Resj.
Vermont. Een der Ver. Staten van N. Amerika.	Vermont.	Ver-mont.
Verpligten.	To oblige.	Toe oo-blijdzj.
Verstand.	Understanding.	On-der-stan-ding.
Verschoonen.	To excuse.	Toe eks-kioez.
Verspreiden.	To spread.	Toe spried.
Verwonderd.	Surprised.	Sur-prijs-id.
Verwonderlijk.	Admirable.	Ed-mie-re-bel.
Vijgen.	Figs.	Figs.
Vijanden.	Ennemies.	En-ne-mies.
Vest.	Waist-coat.	Oewes-koot.
Vinger.	Finger.	Fin-ger.
Vingerhoed.	Thimble.	Them-bel.
Virginia. Een der Ver. Staten van N. Amerika.	Virginia.	Vir-gi-nie.
Vlam.	Flame.	Fleem.
Vleesch.	Flesh.	Flesj.



{==33==} {>>pagina-aanduiding<<}


Vleugel.	Wing.	Oewing.
Vliegen.	To fly.	Toe flij.
Voet.	Foot.	Foet.
Voeten.	Feet.	Fiet.
Volk.	People.	Piep-el.
Volkplanting.	Colony.	Col-oo-nie.	
Voorbeeld.	Exemple.	Egz-em-pel.
Voorbijgaan.	To pass.	Toe pes.
Vork.	Fork.	Fork.
Vraag.	Question.	Koewes-sjun.
Vreemdelingen.	Strangers.	Streen-djurz.
Vrijmoedig.	Freely.	Frie-lie.
Vrolijk.	Joy-fal.	Dzjoie-foel
Vuur.	Fire.	Fijr.



W.


Waarheid.	Truth.	Troeth.
Waarschijnlijk.	Probably.	Prob-e-blie.
Wafel.	Wafer.	Oewee-fur.
Waken.	To wake.	Too oeweek.
Walvisch.	Whale.	Hoeweel.
Wandelen.	To walk.	Toe oewoak.
Wandeling.	Walking.	Oewoa-king.
Wandelaar.	Walker.	Oewoa-ker.
Wand.	Wall.	Oewoal.
Waschbank.	Washing-bench.	Oewas-sing-bensj.
Water.	Water.	Oewoa-ter.
Weerlicht.	Lightning.	Lijt-ning.
Weinig.	Little.	Litt-el.
Wensch.	Wish.	Oewisj.
Werk.	Work.	Oework.
Wereld.	World.	Oeworld.
West.	West.	Oewest.
Westewind.	West-wind.	Oewest-oewind.
Westkant.	West-side.	Oewest-sijd.
Weten.	To know.	Toe noo.



{==34==} {>>pagina-aanduiding<<}


Wetten.	Laws.	Loaz.
Wijs.	Wise.	Oewijs.
Wijn.	Wine.	Oewijn.
Wijnglas.	Wine-glass.	Oewijn-glas.
Wild.	Savage.	Sev-vidzj.
Wind.	Wind.	Oewind.
Winst.	Profit.	Prof-fit.
Winter.	Winter.	Oewin-ter.
Winteravond.	Winter-evening.	Oewin-ter-iev-ning.
Wintermorgen.	Winter-morning.	Oewin-ter-mor-ning.
Winterooft.	Winter-fruit.	Oewin-ter-froet.
Wit.	White.	Hoewijt.
Woensdag.	Wednesday.	Oewens-dee.
Wisconsin. Een der Ver. Staten van N. Amerika.	Wisconsin.	Oewis-kon-sin.



Z.


Zaad.	Seed.	Sied.
Zaaijen.	To sow.	Toe soo.
Zacht.	Soft.	Soaft.
Zak.	Bag.	Beg.
Zakboek.	Pocket-book.	Pak-ket-boek.
Zee.	Sea.	Sie.
Zeekat.	Sea-cat.	Sie-ket.
Zeepaard.	Sea-horse.	Sie-hors.
Zeewolf.	Sea-wolf.	Sie-oewolf.
Zeggen.	To say.	Toe see.
Zes.	Six.	Siks.
Zeven.	Seven.	Sev-en.
Ziekte.	Patient	Pee-sjent.
Zien.	To look.	Toe loek.
Zitten.	To sit.	Toe sit.
Zoet.	Sweet.	Swiet.
Zomer.	Summer.	Som-mer.
Zomerhuis	Summer-house.	Som-mer-hous.



{==35==} {>>pagina-aanduiding<<}


Zomermaand.	June.	Dzjoen.
Zomerrogge.	Summer-rie.	Som-mer-rij.
Zomerzon.	Summer-sun.	Som-mer-son.
Zomertijd.	Summer-time.	Som-mer-tijm.
Zon.	Sun.	Son.
Zondaar.	Sinner.	Sin-ner.
Zondag.	Sonday.	Son-dee.
Zonneschijn.	Sun-shine.	Son-sjijn.
Zonnescherm.	Umbrella.	Om-brel-la.
Zorg.	Care.	Keer.
Zout.	Salt.	Solt.
Zoutpot.	Salt-pot.	Solt-pot.
Zuid.	South.	South.
Zuidoost.	South-east.	South-iest.
Zuinig.	Sparing.	Speer-ing.
Zwaar.	Heavy.	Hev-vie.
Zwager.	Brother in law.	Bro-ther in loo.




{==36==} {>>pagina-aanduiding<<}

Door denzelfden Uitgever zal, zoo spoedig eene goede uitvoering
dit toelaat, worden uitgegeven:

ATLAS
DER
VEREENIGDE STATEN van NOORD-AMERIKA,
in 10 Kaarten, met bijvoeging van eene uitvoerige
Tabel, bevattende de opgaaf der
SPOORWEGEN en STOOMBOOTEN
in de VEREENIGDE STATEN, met aanwijzing van den
afstand tusschen de voornaamste steden,
DOOR
A. J. HILLEBRANDS;
In het formaat van den ATLAS van EUROPA, door J. van WIJK, Roelandszoon.

De prijs is bepaald op f 5-00. Alleen de Algemeene Kaart der
Vereenigde Staten en de Tabel zullen afzonderlijk verkrijgbaar zijn,
de Kaart tegen den prijs van f ,,-60, de Tabel tegen f ,,-40.

{==binnenkant achterplat==} {>>pagina-aanduiding<<}


{==achterplat==} {>>pagina-aanduiding<<}

    
DE UITGEVER DEZES DEBITEERT MEDE:

KEUR
VAN
ZEDELIJKE VERTELLINGEN,
uit beroemde Hoogduitsche en andere Schrijvers
bijeenverzameld, door
Charles André (A. van Hasselt.)
Tot leesboek voor de scholen, naar het Fransch, vrij
bewerkt door J. H. Swildens. – Prijs 40 Cent.

DE VERBUIGING
der Zelfstandige en Bijvoegelijke Naamwoorden,
voor de Nederduitsche en Fransche talen. Met
eenige opstellen ter vertaling tot toepassing van
dezelve, door J. van Wijk, Roelandszoon.
15de veel vermeerderde en verbeterde druk. – Prijs 20 Cent.

LA MORALE DE L'ENFANCE
ou quatrains moraux à la portée des enfants,
et rangés par ordre méthodique par Ch. G.
Morel de Vindé. – Prijs 60 Cent.

VERZAMELING
van eene menigte noodzakelijke Zamenspraken met
inlanders van allerlei klassen in de
LAAG MALEISCHE TAAL,
voorafgegaan van eene beknopte Spraakkunst dier
taal, zoo als dat alles door den lageren Maleijer
wordt gesproken en verstaan, door Roorda
van Eijsinga, Jr. – Prijs 60 Cent.




